,word1,word2,relation,freq. (unord),"freq. (w1,w2)","freq. (w2,w1)"
107,airplane,plane,synonymy,15023,11194,3829
327,desk,table,hypernymy.2,4584,3448,1136
29,boy,child,hypernymy.2,4264,3249,1015
148,couch,sofa,synonymy,4218,4090,128
106,person,woman,hypernymy.1,3788,177,3611
2,man,person,hypernymy.2,3763,3558,205
113,shirt,t-shirt,hypernymy.1,2929,2928,1
43,coat,jacket,hypernymy.1,2754,352,2402
35,girl,woman,hypernymy.2,2743,405,2338
123,child,girl,hypernymy.1,2633,646,1987
82,bike,motorcycle,synonymy,2632,0,2632
171,carpet,floor,crossclassified,2435,1697,738
10,jacket,shirt,crossclassified,2366,1552,814
503,jacket,suit,crossclassified,2197,1168,1029
332,counter,table,hypernymy.2,2107,1201,906
130,man,skateboarder,crossclassified,2019,1074,945
52,food,pizza,hypernymy.1,2004,114,1890
144,skateboarder,skater,hypernymy.2,1748,1194,554
4,boy,man,hypernymy.2,1682,467,1215
156,building,house,hypernymy.1,1676,516,1160
598,boat,ship,co-hyponymy,1540,1301,239
440,carpet,rug,synonymy,1525,630,895
281,bench,chair,co-hyponymy,1521,1401,120
108,airplane,jet,hypernymy.1,1491,1319,172
54,car,truck,co-hyponymy,1421,325,1096
26,desk,keyboard,crossclassified,1413,1380,33
169,man,shirt,crossclassified,1390,891,499
12,food,sandwich,hypernymy.1,1385,262,1123
1,man,player,co-hyponymy,1370,1276,94
131,man,skater,crossclassified,1236,861,375
321,counter,sink,crossclassified,1197,591,606
132,man,t-shirt,crossclassified,1145,1145,0
331,counter,countertop,crossclassified,1101,1101,0
100,boy,kid,hypernymy.2,1096,1096,0
165,t-shirt,woman,crossclassified,976,0,976
88,bathtub,tub,synonymy,964,816,148
736,desk,laptop,crossclassified,902,868,34
24,car,vehicle,hypernymy.2,881,874,7
99,boy,person,hypernymy.2,867,800,67
205,motorcycle,wheel,crossclassified,864,862,2
199,player,woman,crossclassified,859,22,837
38,shirt,woman,crossclassified,839,134,705
97,shirt,tie,crossclassified,836,723,113
39,lady,woman,hypernymy.2,798,0,798
291,dress,shirt,crossclassified,791,327,464
146,boy,skateboarder,crossclassified,744,278,466
180,man,woman,co-hyponymy,725,214,511
48,truck,wheel,crossclassified,720,720,0
55,truck,vehicle,hypernymy.2,720,718,2
510,man,skier,crossclassified,712,165,547
149,chair,couch,co-hyponymy,702,279,423
152,bed,pillow,crossclassified,692,692,0
223,man,shoe,crossclassified,675,648,27
40,dress,woman,crossclassified,627,92,535
19,truck,van,hypernymy.1,622,439,183
232,food,hotdog,hypernymy.1,598,39,559
359,bread,sandwich,crossclassified,594,276,318
355,goat,sheep,co-hyponymy,581,95,486
637,bowl,food,crossclassified,576,502,74
159,bull,cow,co-hyponymy,568,53,515
0,batter,man,crossclassified,558,120,438
145,person,skateboarder,hypernymy.1,557,19,538
8,jacket,man,crossclassified,553,267,286
17,car,van,hypernymy.1,541,242,299
13,hotdog,sandwich,hypernymy.2,540,365,175
817,shirt,sweater,co-hyponymy,535,450,85
609,man,surfer,crossclassified,533,210,323
1017,motorcycle,scooter,crossclassified,532,382,150
217,food,table,hypernymy.1,524,9,515
237,boy,t-shirt,crossclassified,523,515,8
312,bench,table,hypernymy.2,522,383,139
32,child,kid,synonymy,515,515,0
116,jet,plane,hypernymy.2,503,154,349
168,cheese,pizza,crossclassified,493,36,457
15,burger,sandwich,hypernymy.2,488,90,398
65,food,salad,hypernymy.1,485,73,412
1087,car,wheel,co-hyponymy,457,457,0
160,animal,cow,hypernymy.1,455,9,446
745,bird,parrot,hypernymy.1,454,349,105
314,boy,skater,crossclassified,451,229,222
83,motorbike,motorcycle,hypernymy.2,447,0,447
438,plate,table,crossclassified,444,6,438
346,jacket,woman,crossclassified,443,129,314
206,pizza,plate,crossclassified,442,442,0
175,floor,rug,crossclassified,439,135,304
361,skier,woman,crossclassified,428,302,126
126,girl,person,hypernymy.2,424,387,37
360,person,skier,hypernymy.1,424,2,422
310,shoe,woman,crossclassified,420,8,412
198,cake,table,crossclassified,407,28,379
358,bread,food,hypernymy.2,400,259,141
375,boy,player,crossclassified,389,355,34
124,girl,kid,hypernymy.2,385,385,0
59,guy,man,hypernymy.2,385,0,385
576,athlete,man,crossclassified,384,1,383
387,animal,giraffe,hypernymy.1,382,0,382
306,surfer,woman,crossclassified,374,154,220
118,cake,food,hypernymy.2,372,290,82
1377,jacket,tie,crossclassified,371,340,31
499,cap,man,crossclassified,370,0,370
1369,cabinet,counter,co-hyponymy,367,105,262
1097,chair,sofa,co-hyponymy,367,335,32
649,baby,child,synonymy,366,74,292
864,cabinet,cupboard,crossclassified,362,362,0
377,bridge,train,crossclassified,359,326,33
294,human,man,synonymy,352,0,352
320,sink,vanity,crossclassified,350,343,7
1007,desk,desktop,crossclassified,340,340,0
755,bread,bun,hypernymy.1,336,218,118
1005,suit,tie,crossclassified,328,297,31
170,clothing,shirt,hypernymy.1,324,0,324
193,jacket,sweater,crossclassified,324,267,57
308,athlete,woman,crossclassified,310,3,307
109,aircraft,airplane,hypernymy.1,309,0,309
785,car,suv,hypernymy.1,307,298,9
105,boy,shirt,crossclassified,303,242,61
325,bed,couch,hypernymy.1,301,141,160
733,boat,sailboat,crossclassified,301,286,15
493,human,woman,crossclassified,298,0,298
353,animal,sheep,hypernymy.1,295,1,294
999,cup,mug,co-hyponymy,286,163,123
1640,man,snowboarder,crossclassified,286,90,196
812,man,tie,crossclassified,285,281,4
215,pizza,table,crossclassified,283,59,224
354,lamb,sheep,crossclassified,282,0,282
96,train,vehicle,crossclassified,278,278,0
471,bed,blanket,hypernymy.1,271,254,17
712,shoe,skateboarder,crossclassified,270,25,245
388,animal,horse,hypernymy.1,269,0,269
167,female,woman,hypernymy.1,261,0,261
328,jersey,shirt,hypernymy.2,251,59,192
102,boy,shoe,crossclassified,248,240,8
1856,laptop,table,crossclassified,247,20,227
188,bird,duck,hypernymy.1,247,149,98
682,man,pitcher,crossclassified,245,138,107
244,locomotive,train,crossclassified,243,0,243
444,carpet,table,crossclassified,243,198,45
791,cap,hat,co-hyponymy,243,0,243
741,boat,canoe,hypernymy.1,243,243,0
385,bowl,plate,co-hyponymy,243,205,38
506,person,skater,hypernymy.1,242,16,226
53,bed,mattress,crossclassified,241,241,0
151,animal,cat,hypernymy.1,241,2,239
31,child,person,hypernymy.2,239,220,19
694,dress,man,crossclassified,238,1,237
390,child,toddler,hypernymy.1,237,237,0
981,bowl,soup,crossclassified,237,191,46
2264,catcher,man,crossclassified,236,207,29
643,bridge,overpass,hypernymy.1,235,235,0
475,bun,hotdog,crossclassified,235,26,209
44,clothing,jacket,hypernymy.1,235,0,235
225,bird,seagull,hypernymy.1,231,231,0
60,male,man,hypernymy.1,228,0,228
608,necktie,tie,synonymy,228,0,228
1075,cat,chair,crossclassified,227,37,190
717,child,skier,crossclassified,226,156,70
1472,belt,horse,crossclassified,226,0,226
873,food,plate,hypernymy.1,222,173,49
84,motorcycle,vehicle,hypernymy.2,222,222,0
186,donut,food,hypernymy.2,220,212,8
51,pizza,toppings,crossclassified,219,219,0
47,cat,dog,crossclassified,214,105,109
1004,shirt,suit,co-hyponymy,213,125,88
318,animal,dog,hypernymy.1,212,6,206
1292,person,snowboarder,hypernymy.1,210,13,197
203,cat,kitten,crossclassified,208,200,8
415,blouse,shirt,crossclassified,207,0,207
518,jacket,t-shirt,crossclassified,206,206,0
342,counter,vanity,co-hyponymy,205,198,7
1108,computer,desk,crossclassified,204,0,204
474,couch,pillow,crossclassified,204,204,0
219,phone,woman,crossclassified,202,0,202
421,counter,desk,co-hyponymy,201,72,129
345,cap,woman,crossclassified,200,0,200
630,bus,truck,crossclassified,199,56,143
810,dress,jacket,crossclassified,198,72,126
268,giraffe,zebra,crossclassified,197,120,77
3164,bed,carpet,crossclassified,195,29,166
437,glass,table,crossclassified,193,2,191
195,table,vase,crossclassified,190,173,17
1086,bowl,fruit,crossclassified,189,170,19
653,man,pant,crossclassified,188,188,0
1544,train,truck,crossclassified,188,114,74
983,food,soup,hypernymy.1,188,41,147
5153,bookshelf,shelf,hypernymy.2,187,144,43
1283,desk,mouse,crossclassified,187,187,0
2227,chair,table,crossclassified,184,88,96
784,rug,table,crossclassified,184,153,31
1018,moped,motorcycle,hypernymy.2,182,10,172
1408,skier,snowboarder,crossclassified,181,42,139
1582,bowl,cup,co-hyponymy,179,150,29
1785,chair,dog,crossclassified,178,155,23
866,cabinet,table,co-hyponymy,174,105,69
1180,blazer,jacket,hypernymy.2,174,0,174
248,bench,furniture,hypernymy.2,174,174,0
1224,bus,train,co-hyponymy,173,31,142
127,girl,t-shirt,crossclassified,170,170,0
184,couch,furniture,hypernymy.2,166,158,8
233,burger,hotdog,co-hyponymy,165,0,165
757,bread,cake,co-hyponymy,165,64,101
1645,curtain,screen,hypernymy.2,163,163,0
213,animal,zebra,hypernymy.1,163,1,162
835,airplane,wheel,crossclassified,162,162,0
1006,coat,suit,crossclassified,161,34,127
1089,glass,woman,crossclassified,161,0,161
1088,car,taxi,hypernymy.1,161,119,42
1813,house,window,crossclassified,161,161,0
816,shirt,sweatshirt,crossclassified,160,140,20
2023,mat,rug,co-hyponymy,160,0,160
287,plate,sandwich,crossclassified,160,4,156
594,bed,table,crossclassified,158,124,34
820,bun,sandwich,crossclassified,158,28,130
504,dog,puppy,hypernymy.1,158,141,17
383,subway,train,crossclassified,157,0,157
57,curtain,window,crossclassified,156,111,45
21,van,vehicle,hypernymy.2,155,155,0
27,desk,electronics,crossclassified,155,155,0
540,countertop,table,crossclassified,155,0,155
838,couch,t-shirt,crossclassified,154,154,0
1168,food,rice,hypernymy.1,152,44,108
461,bag,woman,crossclassified,152,0,152
453,pot,vase,crossclassified,151,10,141
760,cup,table,crossclassified,151,13,138
23,automobile,car,synonymy,150,0,150
636,bowl,salad,crossclassified,150,97,53
374,batter,boy,crossclassified,150,15,135
1161,bed,cat,crossclassified,150,121,29
279,bench,shoe,crossclassified,149,149,0
5152,bookcase,bookshelf,crossclassified,148,0,148
177,floor,table,co-hyponymy,148,70,78
5122,cat,desk,crossclassified,147,2,145
515,airplane,wing,crossclassified,147,87,60
7,jacket,sweatshirt,crossclassified,146,131,15
1264,cabinet,cabinets,synonymy,146,127,19
1077,skateboarder,woman,crossclassified,145,48,97
611,person,surfer,hypernymy.1,145,0,145
1125,airplane,wings,crossclassified,144,144,0
940,couch,table,crossclassified,143,125,18
1164,shirt,vest,co-hyponymy,142,100,42
941,cat,couch,crossclassified,141,11,130
1319,coat,shirt,crossclassified,141,32,109
128,girl,shirt,crossclassified,141,113,28
1190,horse,shoe,crossclassified,141,141,0
1482,couch,dog,crossclassified,139,106,33
710,jeep,truck,crossclassified,139,25,114
236,boy,cap,crossclassified,139,139,0
726,cake,dessert,crossclassified,139,133,6
713,skateboard,skateboarder,crossclassified,139,9,130
720,engine,train,crossclassified,138,0,138
380,dress,girl,crossclassified,136,18,118
990,bottle,wine,crossclassified,135,134,1
216,table,tabletop,crossclassified,135,135,0
2245,snowboarder,woman,crossclassified,134,92,42
303,chair,seat,hypernymy.2,134,96,38
1214,carpet,cat,crossclassified,134,110,24
282,bench,seat,hypernymy.2,133,122,11
528,cabinet,dresser,hypernymy.1,132,72,60
2002,bench,wood,crossclassified,132,132,0
348,airplane,jetliner,hypernymy.1,131,131,0
724,cake,pie,crossclassified,130,96,34
1109,canopy,tent,crossclassified,129,9,120
1091,couch,loveseat,hypernymy.1,129,129,0
1365,train,trolley,crossclassified,128,117,11
414,car,mirror,crossclassified,128,102,26
6,bat,man,crossclassified,127,5,122
872,coat,man,crossclassified,127,16,111
677,food,meat,hypernymy.1,127,71,56
3332,building,restaurant,hypernymy.1,127,67,60
697,counter,kitchen,crossclassified,125,123,2
3396,chair,shirt,crossclassified,124,100,24
790,bat,woman,crossclassified,124,0,124
1096,armchair,chair,hypernymy.2,124,0,124
489,umbrella,woman,crossclassified,123,0,123
1764,cabinet,shelf,crossclassified,123,81,42
121,home,house,synonymy,123,0,123
924,bed,laptop,crossclassified,122,121,1
423,building,castle,hypernymy.1,122,101,21
241,child,shirt,crossclassified,121,84,37
2358,couch,laptop,crossclassified,121,117,4
1189,horse,pony,hypernymy.1,120,120,0
447,batter,player,hypernymy.2,119,76,43
513,jacket,skier,crossclassified,119,24,95
517,airplane,flight,crossclassified,119,119,0
3389,moped,scooter,crossclassified,119,10,109
386,bowl,dish,hypernymy.2,119,114,5
158,aircraft,plane,hypernymy.1,118,0,118
1421,cup,glass,co-hyponymy,117,61,56
696,counter,stove,crossclassified,115,97,18
459,counter,food,crossclassified,115,106,9
1235,chair,rug,crossclassified,113,14,99
2810,broccoli,food,hypernymy.2,113,68,45
925,person,shirt,crossclassified,113,25,88
2674,coffee,cup,crossclassified,113,9,104
4572,bed,floor,crossclassified,112,61,51
616,chair,man,crossclassified,112,72,40
3429,counter,pizza,crossclassified,111,93,18
1392,bridge,building,co-hyponymy,111,98,13
1130,pant,woman,crossclassified,110,0,110
1751,bathtub,sink,crossclassified,110,77,33
373,bench,t-shirt,crossclassified,110,110,0
1024,cake,donut,hypernymy.1,110,3,107
1323,carpet,chair,crossclassified,109,93,16
670,countertop,sink,crossclassified,109,0,109
323,couch,shirt,crossclassified,108,108,0
658,train,tram,crossclassified,108,108,0
2828,chair,floor,crossclassified,107,14,93
624,bird,goose,hypernymy.1,107,59,48
2568,food,sauce,hypernymy.1,106,52,54
2262,bed,chair,crossclassified,106,56,50
1052,boy,jacket,crossclassified,106,68,38
247,bench,dog,crossclassified,106,103,3
526,child,t-shirt,crossclassified,105,98,7
532,dresser,table,hypernymy.2,105,58,47
1900,belt,dog,crossclassified,105,0,105
246,bench,cat,crossclassified,104,102,2
1219,baby,boy,crossclassified,104,31,73
680,bed,dog,crossclassified,103,72,31
352,cow,sheep,crossclassified,103,47,56
832,chair,woman,crossclassified,103,16,87
584,chair,desk,crossclassified,102,16,86
945,train,wheel,crossclassified,101,101,0
1875,shelf,table,crossclassified,101,14,87
3,helmet,man,crossclassified,101,1,100
1871,trailer,truck,crossclassified,101,9,92
154,man,suit,crossclassified,101,60,41
716,coat,woman,crossclassified,100,14,86
514,shoe,skier,crossclassified,100,0,100
435,clothing,dress,hypernymy.1,100,0,100
1076,skater,woman,crossclassified,100,12,88
319,cabinet,sink,crossclassified,99,36,63
1079,mobile,woman,crossclassified,99,0,99
336,boy,girl,crossclassified,99,48,51
347,cattle,cow,hypernymy.1,98,0,98
507,shoe,skater,crossclassified,98,23,75
1605,boy,woman,crossclassified,97,28,69
527,cow,horse,crossclassified,97,74,23
1136,boy,toddler,crossclassified,97,97,0
2815,bench,shirt,crossclassified,97,90,7
1622,airplane,vehicle,hypernymy.2,96,96,0
2704,skirt,woman,hypernymy.2,96,0,96
509,pizza,slice,crossclassified,96,96,0
4909,plane,wing,crossclassified,96,40,56
1687,airplane,helicopter,co-hyponymy,96,49,47
1753,bread,hotdog,crossclassified,96,26,70
1830,house,tree,crossclassified,95,71,24
648,horse,rope,crossclassified,95,95,0
759,bottle,table,crossclassified,95,5,90
484,cow,goat,crossclassified,95,80,15
298,car,hood,crossclassified,95,32,63
87,bird,eagle,hypernymy.1,95,73,22
2384,book,desk,crossclassified,94,12,82
1501,calf,cow,crossclassified,94,0,94
2400,cup,drink,hypernymy.2,94,82,12
772,shirt,top,crossclassified,94,94,0
329,polo,shirt,crossclassified,94,0,94
487,camel,giraffe,crossclassified,94,0,94
695,counter,island,crossclassified,93,84,9
1812,bed,sofa,crossclassified,93,89,4
472,bed,bedspread,crossclassified,93,93,0
333,bar,counter,hypernymy.2,93,10,83
4176,cat,curtain,crossclassified,92,12,80
408,boy,dress,crossclassified,92,92,0
155,man,teenager,crossclassified,92,92,0
1462,semi,truck,hypernymy.2,92,0,92
20,bus,van,crossclassified,92,43,49
1344,sandwich,sub,hypernymy.1,91,91,0
1654,fork,spoon,co-hyponymy,91,73,18
91,bath,bathtub,synonymy,90,0,90
932,bench,couch,co-hyponymy,89,43,46
2982,mirror,motorcycle,crossclassified,89,8,81
1912,chair,child,crossclassified,88,63,25
2826,plate,woman,crossclassified,88,1,87
1209,cake,cupcake,hypernymy.1,88,8,80
2269,catcher,player,hypernymy.2,88,86,2
960,cake,shirt,crossclassified,87,0,87
1413,bed,woman,crossclassified,87,54,33
3390,bike,scooter,co-hyponymy,87,1,86
1649,bed,bedding,crossclassified,87,87,0
1927,bowl,table,crossclassified,87,6,81
5535,van,wheel,crossclassified,86,86,0
1533,bench,pant,crossclassified,86,86,0
424,building,church,hypernymy.1,86,70,16
357,bread,toast,hypernymy.1,86,65,21
1971,counter,plate,crossclassified,86,86,0
1185,girl,shoe,crossclassified,86,84,2
222,ball,man,co-hyponymy,85,0,85
1423,bridge,pole,crossclassified,85,85,0
309,child,woman,crossclassified,85,18,67
1904,curtain,curtains,synonymy,85,73,12
2904,bed,cot,hypernymy.1,85,85,0
1234,laptop,man,crossclassified,85,10,75
2378,boat,pole,crossclassified,84,84,0
1031,railcar,train,crossclassified,84,0,84
612,boy,surfer,crossclassified,84,19,65
1182,glass,man,crossclassified,83,0,83
1563,bridge,road,crossclassified,83,62,21
4312,car,jeep,hypernymy.1,81,58,23
782,banana,table,crossclassified,81,5,76
14,cake,sandwich,crossclassified,81,6,75
2684,cabinets,counter,co-hyponymy,81,8,73
2942,keyboard,table,crossclassified,81,2,79
2231,apple,fruit,hypernymy.2,81,60,21
235,athlete,boy,crossclassified,81,1,80
9,jacket,person,crossclassified,81,69,12
162,cow,steer,co-hyponymy,80,80,0
555,cake,woman,crossclassified,80,0,80
2816,bowl,pot,co-hyponymy,80,47,33
480,ram,sheep,hypernymy.2,80,4,76
787,girl,skier,crossclassified,79,35,44
1175,donut,pastry,crossclassified,79,79,0
3318,carpet,sofa,crossclassified,79,79,0
1324,ball,woman,crossclassified,79,0,79
750,bed,comforter,crossclassified,78,78,0
854,burger,food,hypernymy.2,78,28,50
836,bench,man,crossclassified,78,36,42
777,boy,human,crossclassified,77,77,0
1120,boat,raft,crossclassified,77,55,22
661,furniture,table,hypernymy.1,77,1,76
673,building,window,crossclassified,77,69,8
2886,pickup,truck,hypernymy.2,77,0,77
811,chair,jacket,crossclassified,77,47,30
1669,lamp,light,co-hyponymy,76,63,13
411,cake,pizza,co-hyponymy,76,9,67
599,boy,tie,crossclassified,76,64,12
228,bird,sparrow,hypernymy.1,76,76,0
33,child,skateboarder,crossclassified,75,19,56
2790,girl,player,crossclassified,75,69,6
552,table,tablecloth,crossclassified,75,65,10
822,kid,skateboarder,crossclassified,74,0,74
2521,bottle,vase,crossclassified,74,17,57
1117,man,phone,crossclassified,74,74,0
627,bird,crane,hypernymy.1,73,73,0
344,clothing,woman,crossclassified,73,0,73
258,bridge,pier,co-hyponymy,73,60,13
856,cat,table,crossclassified,72,13,59
1159,bed,furniture,hypernymy.2,72,72,0
1259,pan,pot,co-hyponymy,72,50,22
2267,catcher,person,hypernymy.2,72,72,0
2071,food,pasta,hypernymy.1,72,24,48
571,hat,woman,crossclassified,72,8,64
1184,baby,girl,hypernymy.2,72,16,56
912,ball,boy,crossclassified,72,0,72
2411,blender,mixer,hypernymy.2,72,72,0
196,stand,table,hypernymy.2,71,3,68
265,donkey,horse,crossclassified,70,0,70
826,cabinet,desk,crossclassified,70,29,41
1924,pizza,shirt,crossclassified,70,1,69
1210,hair,woman,crossclassified,69,8,61
623,bird,swan,hypernymy.1,69,23,46
1780,horse,statue,crossclassified,69,68,1
500,man,skateboard,crossclassified,69,66,3
2819,bun,food,hypernymy.2,69,47,22
409,boy,teenager,crossclassified,69,69,0
2021,bat,dugout,crossclassified,69,0,69
2464,shirt,uniform,crossclassified,68,68,0
919,food,meal,hypernymy.1,68,68,0
1832,blazer,suit,crossclassified,68,0,68
549,bed,man,crossclassified,68,38,30
153,kid,man,crossclassified,68,0,68
3495,pan,pizza,crossclassified,68,29,39
1680,boy,skier,crossclassified,67,13,54
1691,gamer,man,crossclassified,67,0,67
1267,cabinet,door,crossclassified,67,44,23
1303,beanie,hat,crossclassified,67,0,67
638,bowl,pan,co-hyponymy,67,37,30
1183,girl,toddler,crossclassified,67,67,0
1922,bridge,dock,crossclassified,67,46,21
28,horse,zebra,co-hyponymy,67,5,62
1367,plate,salad,crossclassified,67,7,60
1860,skateboarder,t-shirt,crossclassified,67,67,0
2708,boat,ferry,hypernymy.1,67,67,0
547,child,man,co-hyponymy,67,8,59
1253,bird,hawk,hypernymy.1,66,66,0
644,cake,plate,crossclassified,66,65,1
1065,table,woman,crossclassified,66,5,61
430,building,store,crossclassified,66,60,6
863,cabinet,furniture,hypernymy.2,66,66,0
1961,car,motorcycle,co-hyponymy,66,10,56
1722,chair,recliner,hypernymy.1,66,66,0
1756,garage,house,crossclassified,66,33,33
1503,chair,highchair,hypernymy.1,65,34,31
75,dugout,fence,crossclassified,65,65,0
1928,bench,wooden,crossclassified,65,65,0
1504,chair,toy,crossclassified,65,65,0
1538,food,pan,crossclassified,65,8,57
4204,bird,pelican,hypernymy.1,65,65,0
117,helicopter,plane,co-hyponymy,64,20,44
1476,jug,vase,crossclassified,64,0,64
2829,chair,dress,crossclassified,63,29,34
2834,sandwich,toast,crossclassified,63,37,26
652,hat,man,crossclassified,63,19,44
2243,table,wood,crossclassified,63,63,0
554,pizza,woman,crossclassified,63,2,61
129,girl,jacket,crossclassified,63,44,19
685,boy,pitcher,crossclassified,63,45,18
829,glass,shirt,crossclassified,62,0,62
2670,desk,wire,crossclassified,62,62,0
1510,couple,man,crossclassified,62,32,30
86,bird,owl,hypernymy.1,62,29,33
376,bridge,walkway,crossclassified,62,62,0
85,bird,crow,hypernymy.1,62,62,0
933,bench,sofa,co-hyponymy,61,52,9
1282,desk,wood,crossclassified,61,61,0
683,pitcher,player,hypernymy.2,60,60,0
457,bottle,counter,crossclassified,60,0,60
1819,burger,hamburger,synonymy,60,52,8
1970,cake,man,crossclassified,60,0,60
393,child,jacket,crossclassified,60,39,21
715,people,woman,hypernymy.1,59,0,59
349,airplane,vehicles,hypernymy.2,59,59,0
1281,hamburger,sandwich,hypernymy.2,59,4,55
3118,animal,goat,hypernymy.1,59,4,55
1852,car,train,crossclassified,59,3,56
243,caboose,train,crossclassified,59,0,59
2302,chair,furniture,hypernymy.2,59,54,5
2566,cheese,food,hypernymy.2,58,19,39
647,phone,shirt,crossclassified,58,0,58
1383,bird,flamingo,hypernymy.1,58,5,53
1255,watch,woman,crossclassified,58,0,58
1597,pie,pizza,crossclassified,58,4,54
478,goat,ram,co-hyponymy,58,48,10
324,couch,man,crossclassified,57,46,11
1082,boat,dog,crossclassified,57,56,1
842,pizza,sandwich,crossclassified,57,15,42
1145,airliner,airplane,hypernymy.2,56,0,56
2717,boy,helmet,crossclassified,56,55,1
573,jacket,vest,crossclassified,56,25,31
1373,table,tray,crossclassified,56,44,12
1045,cat,rug,crossclassified,56,6,50
1308,glass,vase,crossclassified,56,12,44
1858,girl,skateboarder,crossclassified,56,42,14
742,boat,kayak,hypernymy.1,55,45,10
227,bird,pigeon,hypernymy.1,55,55,0
2003,bed,bench,crossclassified,55,30,25
754,dude,man,hypernymy.2,55,0,55
78,dugout,pit,crossclassified,55,55,0
2733,laptop,woman,crossclassified,55,0,55
427,building,tower,co-hyponymy,55,32,23
2592,man,table,crossclassified,55,43,12
4268,person,player,hypernymy.1,54,16,38
2043,beer,bottle,crossclassified,54,0,54
1773,plane,wheel,crossclassified,54,54,0
239,child,dress,crossclassified,54,50,4
848,dress,gown,hypernymy.1,54,53,1
210,bed,bedframe,crossclassified,54,54,0
1022,chair,t-shirt,crossclassified,54,54,0
2688,counter,cupboard,crossclassified,54,54,0
3075,teenager,woman,crossclassified,54,0,54
1721,man,teen,crossclassified,54,54,0
272,lettuce,salad,crossclassified,54,15,39
748,fruit,table,crossclassified,53,12,41
428,building,clock,crossclassified,53,41,12
1463,suit,tuxedo,crossclassified,53,53,0
1429,bread,burger,crossclassified,53,50,3
4561,house,hut,crossclassified,53,32,21
895,horse,t-shirt,crossclassified,53,53,0
2489,pot,table,crossclassified,53,0,53
448,batter,person,hypernymy.2,53,47,6
1902,curtain,man,crossclassified,53,52,1
4166,cereal,food,hypernymy.2,53,44,9
1258,jacket,uniform,crossclassified,53,53,0
1853,carpet,dog,crossclassified,52,48,4
3357,bench,dress,crossclassified,52,37,15
161,cow,oxen,hypernymy.2,52,52,0
1867,couch,pant,crossclassified,52,52,0
179,clothing,man,crossclassified,52,0,52
264,cap,child,crossclassified,52,0,52
6514,book,bookshelf,crossclassified,52,0,52
2902,bed,rug,crossclassified,52,11,41
7098,rug,sofa,crossclassified,52,52,0
317,skateboard,skater,crossclassified,52,4,48
1042,cup,vase,crossclassified,52,9,43
7431,carpet,laptop,crossclassified,51,42,9
722,train,vehicles,crossclassified,51,51,0
1154,food,pie,hypernymy.1,51,30,21
1273,cat,laptop,crossclassified,51,48,3
556,food,woman,crossclassified,51,0,51
6036,banana,bowl,crossclassified,51,0,51
3343,flower,flowers,synonymy,51,29,22
4062,bowl,broccoli,crossclassified,51,36,15
1211,grill,woman,crossclassified,51,0,51
2598,robe,shirt,co-hyponymy,50,18,32
1638,desk,furniture,hypernymy.2,50,50,0
761,jersey,man,crossclassified,50,4,46
4000,track,train,crossclassified,50,0,50
1288,cap,dugout,crossclassified,50,0,50
104,boy,chair,crossclassified,50,17,33
122,car,house,crossclassified,50,2,48
5760,book,table,crossclassified,50,5,45
3055,curtain,drapes,synonymy,50,50,0
1261,pan,skillet,hypernymy.1,49,49,0
63,salad,vegetables,crossclassified,49,42,7
1705,court,jacket,crossclassified,49,0,49
978,automobile,truck,co-hyponymy,49,0,49
3523,bottle,woman,crossclassified,49,0,49
764,knife,table,crossclassified,49,10,39
1038,face,woman,crossclassified,49,11,38
1202,bed,bunked,crossclassified,49,37,12
809,bench,jacket,crossclassified,49,28,21
2355,bride,woman,crossclassified,48,9,39
2959,cup,desk,crossclassified,48,11,37
182,man,people,co-hyponymy,48,48,0
735,desk,paper,crossclassified,48,48,0
296,broccoli,salad,crossclassified,48,24,24
2647,door,house,crossclassified,48,8,40
558,food,shirt,crossclassified,48,0,48
714,mother,woman,hypernymy.2,48,0,48
4636,bridge,street,crossclassified,48,29,19
797,coat,dress,crossclassified,47,18,29
1299,bread,pizza,crossclassified,47,11,36
49,ambulance,truck,crossclassified,47,9,38
847,gamer,woman,crossclassified,47,0,47
1217,boy,children,hypernymy.2,47,47,0
2120,man,umpire,crossclassified,47,6,41
50,pizza,sauce,crossclassified,47,46,1
3274,house,pole,crossclassified,47,47,0
3282,pan,tray,crossclassified,47,39,8
2050,cabinet,hutch,crossclassified,47,47,0
1309,jar,vase,hypernymy.1,47,1,46
1249,couch,futon,crossclassified,47,38,9
1653,fork,plate,crossclassified,47,44,3
1586,dog,toy,hypernymy.1,47,33,14
5042,flower,rose,crossclassified,47,22,25
1727,road,street,hypernymy.1,47,16,31
1732,flower,vase,crossclassified,47,18,29
1757,building,garage,hypernymy.1,47,29,18
363,helmet,skier,crossclassified,47,1,46
3870,desk,monitor,crossclassified,46,46,0
4920,dog,truck,crossclassified,46,9,37
2127,chicken,food,hypernymy.2,46,7,39
1962,dessert,food,hypernymy.2,46,16,30
1262,lorry,truck,hypernymy.2,46,0,46
451,banana,woman,crossclassified,46,0,46
650,child,shoe,crossclassified,46,46,0
4213,camera,woman,crossclassified,46,0,46
3464,bed,curtain,crossclassified,46,14,32
1686,airplane,propeller,crossclassified,46,32,14
322,sink,toilet,co-hyponymy,46,19,27
4650,carpet,shoe,crossclassified,46,46,0
3577,banana,shirt,crossclassified,45,22,23
1275,bowl,container,hypernymy.2,45,42,3
711,human,skateboarder,crossclassified,45,0,45
3767,chair,wheelchair,hypernymy.1,45,7,38
6003,bridge,sidewalk,crossclassified,45,28,17
1163,helmet,skateboarder,crossclassified,45,0,45
8628,dog,rug,crossclassified,45,9,36
3686,carpet,couch,crossclassified,45,27,18
2893,desk,floor,crossclassified,45,32,13
1634,dress,kimono,crossclassified,45,28,17
3348,chair,girl,crossclassified,44,28,16
4153,girl,skater,crossclassified,44,33,11
5558,cap,skateboarder,crossclassified,44,0,44
2333,cat,hat,crossclassified,44,0,44
4371,counter,cup,crossclassified,44,44,0
1543,curtain,shower,crossclassified,44,22,22
2854,shirt,table,crossclassified,44,11,33
3367,car,meter,crossclassified,44,44,0
399,crust,pizza,crossclassified,44,8,36
1931,sink,washbasin,hypernymy.1,44,44,0
1677,bird,peacock,hypernymy.1,44,26,18
634,tie,woman,crossclassified,44,0,44
3419,bird,hummingbird,hypernymy.1,44,44,0
2564,dog,woman,crossclassified,44,0,44
3384,restaurant,store,crossclassified,43,37,6
6773,building,bus,crossclassified,43,27,16
1554,food,toast,hypernymy.1,43,30,13
538,bench,woman,crossclassified,43,12,31
1295,person,shoe,crossclassified,43,19,24
3093,tent,umbrella,crossclassified,43,15,28
3460,urn,vase,hypernymy.2,43,0,43
3801,bottle,glass,co-hyponymy,43,40,3
1697,bridge,fence,crossclassified,43,43,0
4294,couch,dress,crossclassified,43,41,2
607,t-shirt,table,crossclassified,43,0,43
2415,bed,girl,crossclassified,43,20,23
2337,dugout,helmet,crossclassified,43,43,0
4215,cabinet,closet,co-hyponymy,42,42,0
2502,building,shed,hypernymy.1,42,4,38
2271,catcher,helmet,crossclassified,42,42,0
815,horse,shirt,crossclassified,42,42,0
1114,bowl,vase,crossclassified,42,22,20
1803,bar,table,hypernymy.2,42,11,31
1055,counter,glass,crossclassified,42,42,0
2111,couch,woman,crossclassified,42,30,12
2349,curtain,wall,crossclassified,42,22,20
3803,batter,child,crossclassified,42,10,32
561,bird,ostrich,hypernymy.1,42,25,17
36,mom,woman,crossclassified,41,0,41
1469,food,spoon,crossclassified,41,9,32
1132,couple,woman,crossclassified,41,8,33
3172,bed,t-shirt,crossclassified,41,41,0
2957,cheese,sandwich,crossclassified,41,1,40
1250,desk,dresser,co-hyponymy,41,25,16
1193,food,fruit,crossclassified,41,20,21
2268,catcher,umpire,crossclassified,41,33,8
1370,chair,counter,crossclassified,41,1,40
2610,girl,hair,crossclassified,41,28,13
2013,bench,dugout,crossclassified,41,0,41
986,sink,table,crossclassified,41,39,2
2545,bench,booth,crossclassified,41,19,22
3536,cabin,house,hypernymy.2,41,0,41
2665,bagel,donut,crossclassified,41,16,25
1595,pole,train,crossclassified,41,0,41
2499,house,shed,crossclassified,41,14,27
655,dog,hat,crossclassified,41,4,37
209,ball,girl,crossclassified,40,0,40
1026,bowl,cereal,crossclassified,40,39,1
488,sunglasses,woman,crossclassified,40,0,40
2405,bun,burger,crossclassified,40,34,6
5824,carpet,desk,crossclassified,40,27,13
30,child,skater,crossclassified,40,13,27
2275,airplane,train,crossclassified,40,11,29
10615,desk,flowerpot,crossclassified,40,40,0
419,counter,shelf,crossclassified,40,31,9
1122,camera,man,crossclassified,40,0,40
1269,man,motorcycle,crossclassified,40,18,22
2020,dugout,t-shirt,crossclassified,40,40,0
3034,girl,surfer,crossclassified,40,5,35
691,chef,man,crossclassified,40,0,40
3322,herd,sheep,crossclassified,40,0,40
702,blender,pitcher,crossclassified,39,32,7
384,bowl,orange,crossclassified,39,39,0
693,man,pizza,crossclassified,39,38,1
2517,shirt,skateboarder,crossclassified,39,1,38
987,bottle,drink,crossclassified,39,39,0
285,girl,human,crossclassified,39,39,0
45,jacket,parka,hypernymy.1,39,39,0
928,bat,shirt,crossclassified,39,0,39
2270,catcher,shoe,crossclassified,39,39,0
1291,man,skating,crossclassified,39,39,0
578,desk,shelf,crossclassified,39,30,9
3843,flower,table,crossclassified,39,0,39
429,building,sign,co-hyponymy,39,30,9
2330,boat,yacht,co-hyponymy,39,39,0
3004,jacket,robe,crossclassified,39,20,19
862,armoire,cabinet,crossclassified,39,0,39
852,dish,food,hypernymy.2,39,5,34
3639,car,dog,crossclassified,39,25,14
2878,book,woman,crossclassified,38,0,38
1642,boy,snowboarder,crossclassified,38,9,29
728,blouse,dress,crossclassified,38,0,38
6558,laptop,shirt,crossclassified,38,0,38
1278,bowl,bucket,co-hyponymy,38,13,25
2186,bag,man,crossclassified,38,0,38
2716,bat,boy,crossclassified,38,0,38
3762,bag,bench,crossclassified,38,0,38
675,building,hotel,hypernymy.1,38,38,0
37,sweater,woman,crossclassified,38,2,36
768,cyclist,man,crossclassified,37,0,37
1689,man,soldier,hypernymy.1,37,37,0
183,man,shorts,crossclassified,37,37,0
1929,bed,boy,crossclassified,37,10,27
2089,pizza,salad,co-hyponymy,37,30,7
3534,remote,table,crossclassified,37,0,37
4086,chair,curtain,crossclassified,37,9,28
1178,donut,sweet,crossclassified,37,37,0
368,dress,t-shirt,crossclassified,37,36,1
1440,knife,pizza,crossclassified,37,27,10
744,boat,rowboat,hypernymy.1,37,37,0
4629,door,train,crossclassified,37,0,37
5421,airplane,plain,crossclassified,37,37,0
8958,cabinet,vanity,crossclassified,37,34,3
3491,plate,shirt,crossclassified,36,0,36
1410,cap,skier,crossclassified,36,0,36
681,couch,sectional,crossclassified,36,36,0
4926,motorcycle,tyre,crossclassified,36,36,0
1869,couch,seat,hypernymy.2,36,22,14
1403,meal,table,crossclassified,36,0,36
445,train,window,crossclassified,36,36,0
2726,bed,crib,crossclassified,36,29,7
6403,restaurant,storefront,crossclassified,36,28,8
3230,boy,pant,crossclassified,36,36,0
1443,necklace,shirt,crossclassified,36,0,36
2562,building,tree,crossclassified,36,11,25
1113,pizza,tomato,crossclassified,36,36,0
4124,planter,vase,crossclassified,36,10,26
1964,food,fork,crossclassified,36,3,33
1318,bridge,car,crossclassified,36,34,2
5660,car,cat,crossclassified,36,36,0
4969,chair,laptop,crossclassified,36,36,0
5140,bench,wall,crossclassified,35,25,10
1225,bus,vehicle,hypernymy.2,35,35,0
2467,shirt,torso,crossclassified,35,35,0
4715,bench,book,crossclassified,35,35,0
3309,pant,skateboarder,crossclassified,35,0,35
5620,dress,toy,crossclassified,35,34,1
1391,burger,table,crossclassified,35,0,35
2161,chair,pillow,crossclassified,35,35,0
1407,human,skier,crossclassified,35,0,35
3836,cabinet,drawer,crossclassified,35,35,0
1617,island,table,crossclassified,34,6,28
1294,human,person,crossclassified,34,0,34
9043,bowtie,tie,hypernymy.2,34,34,0
492,eyeglass,woman,crossclassified,34,0,34
6005,horse,horses,synonymy,34,34,0
316,kid,skater,crossclassified,34,0,34
1306,phone,table,crossclassified,34,0,34
6194,bookcase,shelf,crossclassified,34,0,34
3546,barn,house,crossclassified,34,7,27
6054,couch,wood,crossclassified,34,34,0
1479,couch,cushion,crossclassified,34,34,0
4328,planter,pot,hypernymy.2,34,10,24
703,blender,cup,crossclassified,34,31,3
1553,face,man,co-hyponymy,34,19,15
2777,curtain,woman,crossclassified,34,24,10
3135,dress,skirt,crossclassified,34,34,0
407,boy,teen,crossclassified,34,34,0
1043,pottery,vase,crossclassified,34,8,26
1505,bear,chair,crossclassified,34,6,28
2118,bed,book,crossclassified,34,34,0
557,donut,shirt,crossclassified,34,0,34
2911,dog,pug,hypernymy.1,33,33,0
1823,jacket,snowboarder,crossclassified,33,10,23
544,house,wall,crossclassified,33,29,4
2899,head,woman,crossclassified,33,0,33
2204,mirror,train,crossclassified,33,0,33
2209,girl,toy,crossclassified,33,33,0
1719,man,plate,crossclassified,33,33,0
1679,kid,skier,crossclassified,33,0,33
2145,horse,pole,crossclassified,33,33,0
2141,table,toy,crossclassified,33,33,0
6408,banana,man,crossclassified,33,0,33
249,shirt,toothbrush,crossclassified,33,31,2
5938,counter,furniture,hypernymy.2,33,33,0
3452,dog,jacket,crossclassified,33,5,28
3024,cheese,hotdog,crossclassified,33,2,31
1567,bridge,railway,crossclassified,33,33,0
1737,bed,shirt,crossclassified,33,27,6
1806,horse,pant,crossclassified,33,33,0
2745,shirt,watch,crossclassified,33,33,0
1639,hotdog,sausage,hypernymy.2,33,33,0
2643,shoe,snowboarder,crossclassified,32,0,32
218,house,roof,crossclassified,32,26,6
883,lamp,streetlight,hypernymy.1,32,26,6
3498,man,photographer,crossclassified,32,32,0
426,building,cathedral,hypernymy.1,32,32,0
1441,burger,pizza,crossclassified,32,0,32
2430,dog,statue,crossclassified,32,32,0
277,bench,benches,synonymy,32,24,8
1336,man,watch,crossclassified,32,32,0
2722,bottle,man,crossclassified,32,0,32
4164,dugout,players,crossclassified,32,32,0
4485,sandwich,shirt,crossclassified,32,1,31
3674,building,wall,crossclassified,32,17,15
577,skateboarder,skating,crossclassified,32,32,0
5484,building,storefront,crossclassified,32,24,8
1720,food,man,crossclassified,32,0,32
1963,food,vegetables,hypernymy.1,31,20,11
3815,batter,woman,crossclassified,31,5,26
1975,boat,wheel,crossclassified,31,31,0
2998,airplane,biplane,hypernymy.1,31,31,0
2475,human,skater,crossclassified,31,0,31
4794,boy,catcher,crossclassified,31,22,9
2963,cow,yak,crossclassified,31,31,0
1592,building,train,crossclassified,31,2,29
2616,cabinet,wooden,crossclassified,31,31,0
1863,bridge,wall,crossclassified,31,31,0
936,ewe,sheep,hypernymy.2,31,0,31
2200,couch,girl,crossclassified,31,29,2
3110,buffet,counter,synonymy,31,11,20
1050,sandwich,table,crossclassified,31,3,28
1216,boat,bridge,crossclassified,31,6,25
684,person,pitcher,hypernymy.1,31,0,31
9630,cake,train,crossclassified,31,17,14
406,class,woman,hypernymy.1,31,0,31
857,bridge,tracks,crossclassified,31,14,17
646,mobile,shirt,crossclassified,31,0,31
371,bench,child,crossclassified,31,24,7
2992,building,door,co-hyponymy,30,14,16
2226,carriage,train,crossclassified,30,4,26
7377,man,wheel,co-hyponymy,30,30,0
6891,cat,floor,crossclassified,30,19,11
2795,fish,food,hypernymy.2,30,13,17
458,bowl,counter,crossclassified,30,0,30
1179,jacket,scarf,crossclassified,30,30,0
1048,apple,food,hypernymy.2,30,27,3
2254,kid,woman,crossclassified,30,0,30
2773,chair,wood,crossclassified,30,30,0
1794,plane,wings,crossclassified,30,30,0
4063,cabinet,refrigerator,crossclassified,30,21,9
788,donut,table,crossclassified,30,0,30
4624,dessert,donut,crossclassified,30,1,29
1014,salad,vegetable,crossclassified,30,30,0
267,zebra,zebras,synonymy,30,30,0
1268,man,rider,crossclassified,30,30,0
5636,car,dashboard,crossclassified,30,30,0
4657,airplane,runway,crossclassified,30,25,5
6515,bookshelf,shelves,hypernymy.2,30,30,0
4800,bench,fence,crossclassified,29,24,5
4689,food,pancake,hypernymy.1,29,11,18
5053,beach,sand,crossclassified,29,19,10
2291,cake,girl,crossclassified,29,0,29
2106,fork,table,crossclassified,29,7,22
79,dugout,gallery,crossclassified,29,29,0
6474,flight,plane,crossclassified,29,0,29
1420,cat,feline,hypernymy.2,29,29,0
300,bathtub,toilet,crossclassified,29,19,10
535,arm,shirt,crossclassified,29,1,28
3155,apple,bowl,crossclassified,29,0,29
1571,car,sedan,hypernymy.1,29,29,0
3268,dog,sofa,crossclassified,29,26,3
566,animal,bird,hypernymy.1,29,0,29
813,airline,airplane,crossclassified,29,0,29
3262,bowtie,shirt,crossclassified,29,0,29
136,bathrobe,robe,hypernymy.2,29,0,29
5332,counter,wood,crossclassified,29,29,0
1693,pizza,topping,crossclassified,29,29,0
3941,family,woman,crossclassified,29,0,29
242,boxcar,train,crossclassified,29,0,29
7709,bench,boy,crossclassified,29,19,10
560,bird,vulture,hypernymy.1,29,29,0
3532,child,player,co-hyponymy,29,25,4
2487,knife,plate,crossclassified,29,16,13
372,bench,girl,crossclassified,29,23,6
226,bird,dove,hypernymy.1,29,29,0
1552,bowl,meal,crossclassified,29,29,0
7261,bird,peak,crossclassified,29,29,0
4228,floor,shoe,crossclassified,29,29,0
1784,jacket,phone,crossclassified,29,29,0
220,car,window,crossclassified,29,27,2
877,bread,plate,crossclassified,28,26,2
1083,boat,chair,crossclassified,28,28,0
3854,house,t-shirt,crossclassified,28,28,0
1980,bed,bellow,crossclassified,28,28,0
7366,cabinet,mirror,crossclassified,28,8,20
1271,bike,man,crossclassified,28,3,25
3672,bed,keyboard,crossclassified,28,28,0
2664,chef,woman,crossclassified,28,0,28
738,counter,tile,crossclassified,28,28,0
6106,jacket,tuxedo,crossclassified,28,28,0
645,cake,fork,crossclassified,28,7,21
1134,table,vegetables,crossclassified,28,28,0
1345,hoagie,sandwich,hypernymy.2,28,0,28
6268,donut,donuts,synonymy,28,17,11
1396,boy,male,hypernymy.2,28,28,0
719,child,helmet,crossclassified,28,28,0
4491,carpet,pant,crossclassified,28,28,0
1816,cook,woman,crossclassified,28,0,28
4557,counter,knife,crossclassified,28,27,1
1550,boy,plate,crossclassified,28,28,0
341,cake,toy,crossclassified,28,25,3
442,carpet,mat,co-hyponymy,28,28,0
366,dress,outfit,hypernymy.1,28,28,0
1397,boy,phone,crossclassified,28,28,0
3335,bed,quilt,crossclassified,28,28,0
190,duck,goose,co-hyponymy,28,7,21
8460,curtain,table,crossclassified,28,27,1
8159,motorcycle,t-shirt,crossclassified,28,28,0
2629,bed,child,crossclassified,27,14,13
5582,pizza,snack,crossclassified,27,27,0
486,cow,dog,co-hyponymy,27,16,11
3657,skateboarder,snowboarder,crossclassified,27,0,27
119,cake,knife,crossclassified,27,10,17
2729,baby,bed,crossclassified,27,5,22
3618,cat,shirt,crossclassified,27,11,16
6197,shelf,shelves,synonymy,27,27,0
2705,sleeveless,woman,crossclassified,27,0,27
3785,bed,dress,crossclassified,27,23,4
6965,apron,shirt,crossclassified,27,5,22
1675,surfer,t-shirt,crossclassified,27,27,0
980,suv,truck,crossclassified,27,7,20
273,lettuce,vegetable,hypernymy.2,27,27,0
2480,skater,t-shirt,crossclassified,27,27,0
1401,bowl,rice,crossclassified,27,16,11
1589,bear,toy,crossclassified,27,0,27
2615,cabinet,wood,crossclassified,27,27,0
1471,child,couch,crossclassified,27,1,26
2887,eyeglass,man,crossclassified,27,0,27
4300,chest,shirt,crossclassified,27,0,27
62,dog,man,crossclassified,27,1,26
2199,couch,remote,crossclassified,27,22,5
251,brush,shirt,crossclassified,27,0,27
2910,mirror,truck,crossclassified,27,1,26
4665,sink,tub,crossclassified,27,15,12
4174,curtain,drape,synonymy,27,27,0
4016,bottle,jar,co-hyponymy,27,9,18
1506,chair,doll,crossclassified,27,27,0
542,spoon,table,crossclassified,27,2,25
800,beer,glass,crossclassified,27,10,17
1286,dugout,shirt,crossclassified,27,21,6
1565,bridge,bus,crossclassified,27,27,0
2783,boat,dock,crossclassified,27,27,0
1335,man,worker,hypernymy.2,27,27,0
1411,shirt,skier,crossclassified,27,0,27
2792,toilet,urinal,co-hyponymy,27,19,8
1128,dugout,team,crossclassified,27,27,0
1402,dinner,table,crossclassified,26,0,26
3685,boat,train,crossclassified,26,20,6
5579,cat,shoe,crossclassified,26,26,0
2880,food,pot,crossclassified,26,1,25
3084,donut,plate,crossclassified,26,26,0
2934,glass,jacket,crossclassified,26,0,26
1439,carpet,furniture,co-hyponymy,26,25,1
2876,person,t-shirt,crossclassified,26,25,1
1667,child,plate,crossclassified,26,26,0
3133,bed,toy,co-hyponymy,26,26,0
7962,field,grass,crossclassified,26,7,19
5686,motor,motorcycle,crossclassified,26,0,26
5860,box,table,crossclassified,26,11,15
5476,child,phone,crossclassified,26,26,0
740,basin,counter,crossclassified,26,0,26
3122,bed,sheets,co-hyponymy,26,26,0
4354,hotdog,ketchup,crossclassified,26,26,0
1197,fruit,plate,crossclassified,26,19,7
2101,car,windshield,crossclassified,26,20,6
5575,batter,shoe,crossclassified,26,21,5
865,cabinet,television,crossclassified,26,18,8
1700,bridge,railing,crossclassified,26,26,0
1535,dessert,table,crossclassified,26,0,26
1774,basin,sink,hypernymy.2,26,0,26
6632,car,light,crossclassified,26,26,0
597,boat,t-shirt,crossclassified,26,26,0
946,giraffe,pole,crossclassified,26,26,0
7867,animal,bear,hypernymy.1,26,10,16
2711,boat,truck,crossclassified,26,24,2
1724,wheel,woman,crossclassified,26,0,26
1257,bag,jacket,crossclassified,26,0,26
76,dugout,stand,crossclassified,26,26,0
3359,bucket,cup,co-hyponymy,26,11,15
114,player,shirt,crossclassified,26,3,23
7950,bird,toucan,hypernymy.1,26,26,0
4218,bread,donut,crossclassified,26,12,14
1745,gravy,sauce,hypernymy.2,26,9,17
2371,cook,man,co-hyponymy,25,0,25
3221,cat,pillow,crossclassified,25,25,0
4216,cabinet,wardrobe,co-hyponymy,25,22,3
2350,cloth,curtain,crossclassified,25,0,25
1848,banana,counter,crossclassified,25,3,22
5534,pizza,snacks,crossclassified,25,25,0
4398,bike,car,co-hyponymy,25,0,25
635,knife,woman,crossclassified,25,0,25
476,hotdog,mustard,crossclassified,25,10,15
1302,bed,wood,crossclassified,25,25,0
1337,hotdog,plate,crossclassified,25,24,1
2978,cloth,dress,crossclassified,25,0,25
3398,baby,chair,crossclassified,25,1,24
3167,donut,jacket,crossclassified,25,0,25
1683,clothing,suit,hypernymy.1,25,0,25
5675,counter,washbasin,crossclassified,25,25,0
2223,goose,swan,crossclassified,25,3,22
1073,house,wooden,crossclassified,25,25,0
4144,hat,helmet,co-hyponymy,25,4,21
6282,sink,tap,co-hyponymy,25,25,0
3489,metro,train,crossclassified,25,0,25
929,dog,plate,crossclassified,25,25,0
1144,tractor,truck,hypernymy.2,25,1,24
3030,bus,car,hypernymy.2,25,14,11
914,bird,stork,hypernymy.1,25,25,0
5215,counter,t-shirt,crossclassified,25,25,0
7789,bun,donut,crossclassified,25,0,25
1481,animal,couch,crossclassified,25,0,25
1379,bread,table,crossclassified,25,2,23
1650,cap,girl,crossclassified,25,0,25
5411,hat,umbrella,crossclassified,25,15,10
669,sink,sinks,synonymy,25,25,0
3471,athlete,player,co-hyponymy,25,2,23
1607,t-shirt,truck,crossclassified,25,0,25
5,man,uniform,crossclassified,25,25,0
6871,building,hut,crossclassified,25,7,18
1664,woman,women,synonymy,25,25,0
3881,nurse,woman,hypernymy.2,25,7,18
3261,collar,shirt,crossclassified,25,9,16
9065,legs,shoe,crossclassified,25,14,11
5094,paper,table,crossclassified,25,0,25
2579,food,grill,crossclassified,25,0,25
2539,bed,bedcover,crossclassified,25,25,0
3470,athlete,batter,hypernymy.1,25,4,21
614,sea,surfer,crossclassified,24,0,24
4189,flock,sheep,crossclassified,24,0,24
5613,bag,bed,crossclassified,24,0,24
1854,carpet,carpeting,synonymy,24,24,0
6626,glove,mitt,synonymy,24,24,0
69,dugout,railing,crossclassified,24,24,0
2574,bed,sheet,co-hyponymy,24,24,0
2513,cap,horse,crossclassified,24,0,24
254,dock,pier,synonymy,24,14,10
1102,hotdog,jacket,crossclassified,24,0,24
2445,dog,poodle,hypernymy.1,24,24,0
774,clothes,shirt,crossclassified,24,0,24
4191,boy,goalie,crossclassified,24,21,3
2702,automobile,motorcycle,co-hyponymy,24,0,24
2744,dog,shirt,crossclassified,24,6,18
2689,counter,oven,crossclassified,24,19,5
1387,boy,skateboard,crossclassified,24,24,0
8964,cellphone,phone,hypernymy.2,24,0,24
860,shirt,shoulder,crossclassified,24,24,0
1926,bench,bridge,crossclassified,24,13,11
3974,boat,wood,crossclassified,24,24,0
4162,bird,penguin,hypernymy.1,24,12,12
1229,bus,wheel,crossclassified,24,24,0
676,food,stew,hypernymy.1,24,24,0
2606,container,food,crossclassified,24,0,24
2347,curtain,t-shirt,crossclassified,24,24,0
4955,class,man,crossclassified,24,0,24
853,dinner,food,hypernymy.2,24,0,24
5866,cabinet,fridge,crossclassified,24,24,0
2351,curtain,shirt,crossclassified,24,23,1
508,shirt,skater,crossclassified,24,2,22
545,house,shirt,crossclassified,24,24,0
3670,bed,desk,crossclassified,24,20,4
2158,couch,floor,crossclassified,24,24,0
723,bed,bedroom,crossclassified,24,24,0
7154,bed,shoe,crossclassified,24,24,0
4881,apple,table,crossclassified,23,0,23
3563,sweater,sweatshirt,hypernymy.1,23,8,15
4017,glass,jar,co-hyponymy,23,1,22
1116,man,mobile,crossclassified,23,23,0
330,ball,shirt,crossclassified,23,0,23
5655,bed,cover,crossclassified,23,23,0
587,hand,shirt,crossclassified,23,0,23
3410,cup,jar,co-hyponymy,23,8,15
4888,head,man,crossclassified,23,2,21
3579,dog,mirror,crossclassified,23,6,17
3484,tire,truck,crossclassified,23,9,14
1008,cat,sink,crossclassified,23,16,7
7396,cabinet,cupboards,crossclassified,23,23,0
5402,couch,shoe,crossclassified,23,23,0
2723,sandwich,snakes,crossclassified,23,23,0
6031,chicken,turkey,co-hyponymy,23,0,23
2736,boat,shirt,crossclassified,23,23,0
3627,flowers,table,crossclassified,23,6,17
6081,burger,shirt,crossclassified,23,0,23
546,girl,man,crossclassified,23,1,22
2323,bench,desk,crossclassified,23,14,9
1717,cow,statue,crossclassified,23,18,5
3927,track,tracks,synonymy,23,0,23
150,cat,kitty,hypernymy.1,23,23,0
590,building,pole,crossclassified,23,23,0
10448,photographer,woman,crossclassified,23,0,23
4139,pizza,tray,crossclassified,23,23,0
3176,cellphone,woman,crossclassified,23,0,23
4915,giraffe,tree,crossclassified,23,21,2
522,jacket,raincoat,co-hyponymy,23,23,0
2151,bowl,spoon,co-hyponymy,23,16,7
2719,boat,building,crossclassified,23,9,14
855,food,pastry,hypernymy.1,23,23,0
189,duck,swan,crossclassified,23,6,17
311,food,knife,crossclassified,23,1,22
1876,sandwich,sandwiches,synonymy,23,23,0
1103,food,jacket,crossclassified,23,1,22
1555,banana,food,hypernymy.2,22,9,13
2036,jacket,motorcycle,crossclassified,22,4,18
3128,clothes,jacket,crossclassified,22,0,22
1165,breakfast,food,hypernymy.2,22,0,22
718,child,human,crossclassified,22,22,0
5134,sandwich,snacks,crossclassified,22,22,0
5012,awning,tent,crossclassified,22,0,22
3594,athlete,girl,crossclassified,22,0,22
3103,face,head,hypernymy.1,22,22,0
3443,oven,stove,co-hyponymy,22,16,6
5524,boat,houseboat,hypernymy.1,22,22,0
3663,boy,couch,crossclassified,22,2,20
2432,cat,hood,crossclassified,22,0,22
1220,helmet,woman,crossclassified,22,10,12
5334,bathtub,cat,crossclassified,22,18,4
3365,house,truck,crossclassified,22,22,0
1616,scatting,skateboarder,crossclassified,22,0,22
2039,girl,skirt,hypernymy.1,22,22,0
1744,boy,table,crossclassified,22,19,3
2142,doll,table,crossclassified,22,0,22
5787,building,tent,crossclassified,22,2,20
2846,motorcycle,motorcycles,synonymy,22,15,7
4862,knife,shirt,crossclassified,22,1,21
2320,boat,sail,crossclassified,22,22,0
6971,bag,cat,crossclassified,22,0,22
1657,skier,t-shirt,crossclassified,22,22,0
753,man,sunglasses,crossclassified,22,22,0
8768,airplane,dropline,crossclassified,22,22,0
4743,mirror,window,crossclassified,22,8,14
1465,court,suit,crossclassified,22,0,22
8060,bed,headboard,crossclassified,22,22,0
2290,electronics,table,crossclassified,22,0,22
2536,board,table,synonymy,22,0,22
6518,awning,sign,crossclassified,22,11,11
804,drink,glass,crossclassified,22,1,21
3796,man,sweater,co-hyponymy,22,16,6
896,boat,tugboat,hypernymy.1,22,22,0
2966,cake,hotdog,crossclassified,22,0,22
6782,motorcycle,shirt,crossclassified,22,22,0
6767,barber,man,crossclassified,22,0,22
1019,motorcycle,vehicles,hypernymy.2,22,22,0
5656,carpet,suitcase,crossclassified,22,13,9
4404,desk,phone,crossclassified,22,22,0
2607,food,tray,crossclassified,22,11,11
2401,bottle,cup,co-hyponymy,22,8,14
595,buffalo,cow,crossclassified,21,0,21
2972,bear,woman,crossclassified,21,10,11
3634,blender,mix,crossclassified,21,21,0
984,cup,soup,crossclassified,21,10,11
3990,chain,shirt,crossclassified,21,0,21
270,cabbage,lettuce,synonymy,21,15,6
6964,apron,dress,crossclassified,21,11,10
2058,dress,skier,crossclassified,21,0,21
7060,curtain,door,crossclassified,21,21,0
1457,giraffe,wooden,crossclassified,21,21,0
6265,horse,woman,crossclassified,21,15,6
2287,bridge,wheel,crossclassified,21,21,0
4673,cap,jacket,synonymy,21,0,21
1458,scarf,woman,crossclassified,21,0,21
6363,building,giraffe,crossclassified,21,15,6
16,automobile,van,crossclassified,21,0,21
3528,food,sausage,hypernymy.1,21,8,13
335,bed,mat,crossclassified,21,21,0
4660,chair,stool,co-hyponymy,21,21,0
898,boy,food,crossclassified,21,21,0
1602,bicycle,motorcycle,crossclassified,21,0,21
2397,chair,tie,crossclassified,21,21,0
4978,building,car,crossclassified,21,13,8
3477,bridge,tunnel,crossclassified,21,21,0
2379,bridge,wooden,crossclassified,21,21,0
11118,balloon,kite,co-hyponymy,21,0,21
843,house,umbrella,crossclassified,21,21,0
7788,car,shirt,crossclassified,21,16,5
839,couch,jacket,crossclassified,21,21,0
491,glasses,woman,crossclassified,21,0,21
3441,dog,motorcycle,crossclassified,21,0,21
783,furniture,rug,co-hyponymy,21,4,17
3400,glasses,man,crossclassified,21,0,21
828,cake,pastry,co-hyponymy,21,21,0
2258,dog,pillow,crossclassified,21,21,0
1855,desktop,table,crossclassified,21,0,21
3165,meat,sandwich,crossclassified,21,7,14
1093,lade,woman,crossclassified,21,0,21
2879,pot,vegetables,crossclassified,21,21,0
1564,bridge,track,crossclassified,21,21,0
3754,couch,rug,crossclassified,21,10,11
1095,coffee,mug,crossclassified,21,5,16
5749,player,shoe,crossclassified,21,16,5
147,guy,skateboarder,crossclassified,21,0,21
743,boat,water,crossclassified,21,21,0
2112,sofa,woman,crossclassified,21,0,21
1656,pant,skier,crossclassified,21,0,21
4873,cycle,woman,crossclassified,21,0,21
678,beef,food,hypernymy.2,21,0,21
2210,doll,girl,hypernymy.2,21,0,21
1068,cellphone,shirt,crossclassified,21,0,21
3905,clothes,dress,synonymy,20,0,20
550,plane,vehicle,hypernymy.2,20,20,0
899,boy,cake,crossclassified,20,20,0
1451,statue,vase,crossclassified,20,0,20
2022,jacket,outfit,crossclassified,20,20,0
3080,drawers,dresser,crossclassified,20,0,20
4992,car,horse,crossclassified,20,14,6
5389,building,umbrella,crossclassified,20,19,1
1706,female,girl,hypernymy.1,20,0,20
7902,building,palace,hypernymy.1,20,20,0
10773,bridge,dam,crossclassified,20,20,0
4644,cake,jacket,crossclassified,20,0,20
541,dog,table,crossclassified,20,8,12
1646,bowl,toilet,crossclassified,20,0,20
8661,blinds,curtain,hypernymy.1,20,0,20
2844,bench,doll,crossclassified,20,20,0
7726,frisbee,shirt,crossclassified,20,9,11
2220,jetliner,plane,hypernymy.2,20,0,20
3387,scooter,wheel,co-hyponymy,20,20,0
5336,doll,dress,crossclassified,20,0,20
3353,bike,woman,crossclassified,20,0,20
1470,child,tie,crossclassified,20,15,5
1254,boat,vehicle,hypernymy.2,20,20,0
1521,light,motorcycle,crossclassified,20,0,20
834,man,remote,crossclassified,20,20,0
1655,pole,skier,crossclassified,20,0,20
579,desk,workstation,crossclassified,20,20,0
1039,brush,woman,crossclassified,20,0,20
2266,cap,catcher,crossclassified,20,0,20
3555,cake,counter,crossclassified,20,0,20
4347,carpet,pants,crossclassified,20,20,0
4911,broccoli,vegetables,hypernymy.2,20,17,3
2488,bag,table,crossclassified,20,0,20
6677,hotdog,hotdogs,synonymy,20,10,10
1953,jacket,skater,crossclassified,20,6,14
512,skating,skier,crossclassified,20,0,20
9102,scissor,table,crossclassified,20,0,20
1390,hotdog,table,crossclassified,20,1,19
7352,mug,table,crossclassified,20,0,20
1968,father,man,crossclassified,20,0,20
3795,horse,saddle,crossclassified,20,20,0
1166,egg,food,hypernymy.2,20,3,17
891,bench,wheel,crossclassified,20,20,0
269,food,lettuce,hypernymy.1,20,0,20
4365,desk,system,crossclassified,20,20,0
4928,clock,house,crossclassified,20,7,13
1432,bag,couch,crossclassified,20,0,20
10213,bib,shirt,crossclassified,19,0,19
431,building,shop,crossclassified,19,19,0
1400,hitter,man,crossclassified,19,0,19
10099,desk,rug,crossclassified,19,5,14
553,jacket,table,crossclassified,19,8,11
890,belt,man,crossclassified,19,0,19
5043,pepperoni,pizza,crossclassified,19,0,19
362,skateboard,skier,crossclassified,19,0,19
11291,sofa,table,crossclassified,19,4,15
5107,car,tire,crossclassified,19,15,4
2410,blender,jar,crossclassified,19,14,5
477,hotdog,wiener,synonymy,19,19,0
3559,bag,carpet,crossclassified,19,0,19
3480,counter,floor,crossclassified,19,16,3
8210,building,roof,crossclassified,19,11,8
2164,cupcake,food,hypernymy.2,19,19,0
2926,sheep,statue,crossclassified,19,10,9
5169,pan,plate,crossclassified,19,19,0
11196,bench,swing,crossclassified,19,19,0
913,bird,heron,hypernymy.1,19,19,0
5743,biplane,plane,hypernymy.2,19,0,19
1880,cap,house,crossclassified,19,0,19
1641,human,snowboarder,crossclassified,19,0,19
3640,animal,bench,crossclassified,19,0,19
2872,jacket,skateboarder,crossclassified,19,8,11
1826,house,sign,synonymy,19,17,2
1431,book,couch,crossclassified,19,0,19
2817,bowl,sauce,crossclassified,19,11,8
2799,food,toppings,crossclassified,19,19,0
1012,salad,sandwich,crossclassified,19,9,10
2732,child,hat,crossclassified,19,19,0
1581,bowl,mug,co-hyponymy,19,19,0
2052,cabinet,rack,crossclassified,19,19,0
10622,boat,sea,crossclassified,19,19,0
2054,bookshelf,cabinet,crossclassified,19,15,4
3789,floor,shirt,crossclassified,19,11,8
793,frisbee,woman,crossclassified,19,0,19
3275,shirt,shoulders,crossclassified,19,19,0
5937,counter,wooden,crossclassified,19,19,0
10589,laptop,rug,crossclassified,19,1,18
8363,top,woman,crossclassified,19,0,19
2791,bidet,toilet,crossclassified,19,5,14
176,floor,furniture,crossclassified,19,18,1
3127,jacket,mobile,crossclassified,19,19,0
769,bicyclist,man,crossclassified,19,0,19
292,dress,person,crossclassified,19,10,9
10926,bench,laptop,crossclassified,19,19,0
11004,floor,laptop,crossclassified,19,11,8
639,bowl,vegetable,crossclassified,19,19,0
780,cap,pitcher,crossclassified,19,0,19
3997,costume,jacket,crossclassified,19,0,19
3730,baby,kid,hypernymy.2,19,19,0
2840,bat,girl,crossclassified,19,0,19
3382,llama,sheep,crossclassified,19,1,18
2621,frisbee,man,crossclassified,19,0,19
2663,spatula,utensil,hypernymy.2,19,19,0
2322,desk,tabletop,crossclassified,19,19,0
6415,baby,toddler,crossclassified,19,19,0
4071,cabinet,t-shirt,crossclassified,19,19,0
1270,man,motorcyclist,crossclassified,19,19,0
4890,camera,jacket,crossclassified,18,0,18
8606,boat,car,crossclassified,18,18,0
379,girl,table,crossclassified,18,18,0
4848,kite,plane,crossclassified,18,18,0
4688,pancake,pancakes,synonymy,18,9,9
3784,bed,person,crossclassified,18,16,2
12730,door,shower,crossclassified,18,0,18
3971,coat,sweater,crossclassified,18,3,15
4847,airplane,kite,crossclassified,18,1,17
4740,hotdog,shirt,crossclassified,18,0,18
2436,racket,woman,crossclassified,18,0,18
5553,bagel,sandwich,crossclassified,18,2,16
1696,bridge,water,crossclassified,18,18,0
5470,airplane,gyroplane,co-hyponymy,18,18,0
6433,food,guacamole,hypernymy.1,18,0,18
3212,carpet,shirt,crossclassified,18,14,4
1064,cloth,woman,crossclassified,18,0,18
1206,jacket,plate,co-hyponymy,18,18,0
3158,train,wall,crossclassified,18,18,0
6253,plane,propeller,crossclassified,18,6,12
8287,truck,tyre,crossclassified,18,18,0
704,blender,glass,crossclassified,18,18,0
4314,doll,shirt,crossclassified,18,0,18
533,dresser,wardrobe,co-hyponymy,18,14,4
2315,airplane,airport,crossclassified,18,17,1
1146,jacket,statue,crossclassified,18,18,0
2298,croissant,food,hypernymy.2,18,12,6
4315,shirt,toy,crossclassified,18,15,3
1131,remote,woman,crossclassified,18,0,18
1115,bowl,glass,co-hyponymy,18,18,0
7071,ramp,skateboard,crossclassified,18,4,14
2285,doll,jacket,crossclassified,18,0,18
5750,player,t-shirt,crossclassified,18,18,0
1923,boardwalk,bridge,crossclassified,18,0,18
4192,boy,jersey,crossclassified,18,18,0
1578,boy,pizza,crossclassified,18,16,2
1078,skateboard,woman,crossclassified,18,0,18
2833,curtain,dog,crossclassified,18,18,0
1037,toothbrush,woman,crossclassified,18,0,18
2263,chair,person,hypernymy.2,18,17,1
2361,blanket,couch,crossclassified,18,7,11
686,pitcher,shoe,crossclassified,18,18,0
1066,door,truck,crossclassified,18,5,13
1930,court,man,crossclassified,18,4,14
3481,counter,cupboards,crossclassified,18,18,0
2040,skate,skier,crossclassified,18,0,18
1630,skater,snowboarder,crossclassified,18,1,17
1635,costume,dress,hypernymy.2,18,0,18
1636,dress,suit,crossclassified,18,4,14
1726,rider,woman,crossclassified,18,0,18
5327,couch,tie,crossclassified,18,8,10
11,giraffe,woman,crossclassified,18,12,6
5216,counter,shirt,crossclassified,18,14,4
3344,flowers,vase,crossclassified,18,10,8
2031,bowl,noodles,crossclassified,18,18,0
4460,ring,shirt,crossclassified,18,0,18
4108,flower,plant,hypernymy.2,18,6,12
931,businessman,man,crossclassified,18,0,18
120,apartment,house,crossclassified,17,0,17
6757,cheese,mustard,crossclassified,17,1,16
876,dish,plate,co-hyponymy,17,0,17
2439,cake,cookie,hypernymy.1,17,9,8
2292,food,girl,crossclassified,17,0,17
564,bird,turkey,hypernymy.1,17,6,11
1835,man,train,crossclassified,17,6,11
5889,table,train,crossclassified,17,1,16
5974,motorcycle,shoe,crossclassified,17,17,0
41,teen,woman,crossclassified,17,0,17
1013,dish,salad,hypernymy.1,17,0,17
7126,baby,shirt,crossclassified,17,3,14
2465,outfit,shirt,crossclassified,17,0,17
1594,t-shirt,train,crossclassified,17,0,17
6028,food,turkey,hypernymy.1,17,0,17
6486,sidewalk,walkway,hypernymy.2,17,17,0
8112,cabinet,shirt,crossclassified,17,17,0
1793,dress,sweater,crossclassified,17,12,5
2596,necktie,shirt,crossclassified,17,0,17
8520,desk,plate,crossclassified,17,17,0
6361,giraffe,shelter,crossclassified,17,9,8
840,couch,person,crossclassified,17,17,0
2335,dad,man,crossclassified,17,0,17
3909,tie,vest,crossclassified,17,3,14
2648,apple,desk,crossclassified,17,0,17
1804,house,porch,crossclassified,17,17,0
7995,shirt,spoon,crossclassified,17,17,0
2516,woman,worker,hypernymy.2,17,17,0
2404,cup,food,hypernymy.2,17,14,3
6627,ball,glove,crossclassified,17,0,17
101,boy,guy,co-hyponymy,17,17,0
5071,desk,pen,crossclassified,17,17,0
3775,dugout,wall,crossclassified,17,16,1
252,bottle,shirt,crossclassified,17,0,17
1839,house,man,crossclassified,17,16,1
679,skater,skier,co-hyponymy,17,0,17
674,building,home,crossclassified,17,17,0
1230,dog,sheep,crossclassified,17,1,16
266,horse,mule,co-hyponymy,17,17,0
8376,belt,bridge,crossclassified,17,0,17
5387,cookie,food,hypernymy.2,17,17,0
9398,building,dugout,crossclassified,17,0,17
1731,car,t-shirt,crossclassified,17,17,0
4563,house,shack,crossclassified,17,17,0
7623,bench,counter,crossclassified,17,7,10
3585,man,vest,crossclassified,17,10,7
1955,jacket,overcoat,co-hyponymy,17,17,0
4532,man,zombie,crossclassified,17,17,0
1363,cat,house,crossclassified,17,0,17
1941,light,train,crossclassified,17,0,17
4986,glove,hand,crossclassified,17,17,0
4007,bat,batter,crossclassified,17,6,11
543,boy,house,crossclassified,17,0,17
5133,rug,wood,crossclassified,17,17,0
5087,bowl,cat,crossclassified,17,10,7
5527,furniture,sofa,hypernymy.1,17,10,7
3213,carpet,t-shirt,crossclassified,17,17,0
1181,man,polo,crossclassified,17,17,0
2115,cat,keyboard,crossclassified,17,16,1
5771,kite,woman,crossclassified,17,0,17
1498,coat,tie,crossclassified,17,15,2
1074,animal,chair,crossclassified,17,0,17
2843,bench,toy,crossclassified,17,17,0
10299,cake,curtain,crossclassified,17,0,17
7231,house,wheel,crossclassified,17,17,0
2197,boy,shorts,crossclassified,17,17,0
7253,burrito,food,hypernymy.2,17,3,14
392,brush,child,crossclassified,17,0,17
2189,plate,soup,crossclassified,17,0,17
194,display,table,crossclassified,17,0,17
2909,horse,jacket,crossclassified,17,13,4
8956,chair,glass,crossclassified,17,17,0
1557,banana,jacket,crossclassified,17,8,9
730,bag,dress,crossclassified,17,0,17
1147,desk,man,crossclassified,17,15,2
3006,girl,umbrella,crossclassified,17,17,0
1170,spatula,spoon,crossclassified,17,14,3
13554,bird,kite,hypernymy.1,17,0,17
1090,cup,woman,crossclassified,17,0,17
1599,flatbread,pizza,crossclassified,16,0,16
8037,cat,mirror,crossclassified,16,12,4
4529,computer,laptop,hypernymy.1,16,0,16
454,jag,vase,crossclassified,16,0,16
1699,bridge,guardrail,crossclassified,16,16,0
4618,food,waffle,hypernymy.1,16,0,16
1609,burger,woman,crossclassified,16,0,16
2011,dugout,man,crossclassified,16,16,0
2709,barge,boat,hypernymy.2,16,0,16
988,bottle,water,crossclassified,16,15,1
1199,fruit,orange,hypernymy.1,16,16,0
972,hotdog,pizza,crossclassified,16,16,0
5461,motorcycle,road,crossclassified,16,9,7
6263,chair,shoe,crossclassified,16,16,0
672,building,cafe,hypernymy.1,16,16,0
3292,salad,table,crossclassified,16,1,15
1248,brush,counter,crossclassified,16,0,16
2357,bull,horse,crossclassified,16,14,2
1252,dresser,furniture,hypernymy.2,16,16,0
7407,electronics,woman,crossclassified,16,0,16
3323,animals,sheep,hypernymy.1,16,0,16
3328,light,truck,crossclassified,16,0,16
2029,bowl,pasta,crossclassified,16,15,1
6446,donut,sign,crossclassified,16,16,0
3355,bicycle,man,crossclassified,16,0,16
2246,pole,woman,crossclassified,16,0,16
7030,cabinet,oven,crossclassified,16,11,5
1172,toy,woman,crossclassified,16,0,16
6450,hat,turban,hypernymy.1,16,12,4
3045,purse,woman,crossclassified,16,1,15
5773,male,skateboarder,crossclassified,16,0,16
1032,train,umbrella,crossclassified,16,16,0
2278,scarf,shirt,co-hyponymy,16,0,16
758,breakfast,table,crossclassified,16,0,16
756,bread,roll,hypernymy.1,16,16,0
5678,specs,woman,crossclassified,16,0,16
2913,dessert,pizza,crossclassified,16,11,5
2280,jacket,toy,crossclassified,16,16,0
2952,controller,woman,crossclassified,16,0,16
12143,baby,highchair,crossclassified,16,0,16
1023,chair,pant,crossclassified,16,16,0
796,dress,phone,crossclassified,16,16,0
731,cake,dress,crossclassified,16,0,16
2960,countertop,desk,crossclassified,16,0,16
214,airplane,hydroplane,hypernymy.1,16,16,0
2293,croissant,sandwich,crossclassified,16,10,6
721,train,wagon,crossclassified,16,16,0
5338,car,woman,crossclassified,16,7,9
2240,coat,overcoat,hypernymy.1,16,16,0
14560,airplane,complainer,crossclassified,16,16,0
894,banana,knife,crossclassified,16,0,16
6519,board,sign,crossclassified,16,0,16
1896,building,station,crossclassified,16,16,0
2515,paper,woman,crossclassified,16,0,16
3607,girl,laptop,crossclassified,16,16,0
3911,coat,vest,crossclassified,16,0,16
3632,bed,futon,crossclassified,16,9,7
3880,clothing,skateboarder,crossclassified,16,0,16
1807,gown,shirt,co-hyponymy,16,8,8
888,lifeguard,man,crossclassified,16,0,16
1842,house,shoe,crossclassified,16,16,0
1427,shirts,woman,crossclassified,16,0,16
7844,coleslaw,salad,hypernymy.2,16,9,7
6700,hood,vent,crossclassified,16,0,16
572,suit,vest,co-hyponymy,16,2,14
5145,children,girl,hypernymy.1,16,0,16
3519,dresser,vanity,synonymy,16,16,0
6844,bird,birds,synonymy,16,16,0
2537,fruit,fruits,synonymy,16,16,0
5321,chicken,rooster,hypernymy.1,16,6,10
5312,hat,toy,crossclassified,16,15,1
295,pasta,salad,co-hyponymy,16,15,1
844,gown,woman,crossclassified,16,0,16
9252,counter,laptop,crossclassified,16,14,2
1305,computer,table,crossclassified,16,0,16
6885,building,temple,hypernymy.1,16,6,10
2388,traveler,woman,crossclassified,16,0,16
3490,bagel,food,hypernymy.2,16,14,2
3492,child,table,crossclassified,16,14,2
3513,hotdog,snakes,crossclassified,16,16,0
1328,bridge,light,crossclassified,16,16,0
3518,bureau,dresser,synonymy,16,0,16
1817,arm,woman,crossclassified,16,4,12
2485,dress,table,crossclassified,15,7,8
125,girl,plate,crossclassified,15,15,0
10569,fruit,melon,hypernymy.1,15,0,15
11088,clock,curtain,crossclassified,15,0,15
2495,car,glass,crossclassified,15,15,0
2511,man,pole,crossclassified,15,15,0
2372,cat,window,crossclassified,15,7,8
2680,suv,van,crossclassified,15,1,14
2677,cup,juice,crossclassified,15,15,0
70,dugout,sideline,crossclassified,15,15,0
3938,train,transportation,crossclassified,15,15,0
8296,building,light,crossclassified,15,15,0
11859,bed,beds,synonymy,15,15,0
3605,dog,frisbee,crossclassified,15,15,0
9310,broccoli,fork,crossclassified,15,0,15
4057,coat,skier,crossclassified,15,3,12
4030,boy,uniform,crossclassified,15,15,0
9203,kimono,shirt,crossclassified,15,15,0
1956,child,snowboarder,crossclassified,15,8,7
3548,man,umbrella,crossclassified,15,15,0
3610,boy,clothing,crossclassified,15,15,0
2001,bench,pillow,crossclassified,15,15,0
1747,food,gravy,hypernymy.1,15,8,7
1877,house,woman,crossclassified,15,14,1
3688,controller,couch,crossclassified,15,0,15
8791,box,cereal,crossclassified,15,15,0
1762,burger,man,crossclassified,15,0,15
3925,dress,robe,crossclassified,15,4,11
3388,motorbike,scooter,crossclassified,15,0,15
278,bench,pole,crossclassified,15,15,0
10380,cat,jacket,crossclassified,15,1,14
234,boy,hat,crossclassified,15,15,0
2851,mobile,table,crossclassified,15,0,15
2870,chair,ottoman,co-hyponymy,15,13,2
2166,cupcake,dessert,crossclassified,15,8,7
1670,lamp,lamppost,crossclassified,15,15,0
2155,apron,woman,crossclassified,15,1,14
3013,cellphone,man,crossclassified,15,0,15
9745,boat,table,crossclassified,15,15,0
1703,bridge,cycle,crossclassified,15,15,0
3095,canopy,umbrella,hypernymy.1,15,3,12
1768,man,sofa,crossclassified,15,15,0
2088,fork,pizza,crossclassified,15,4,11
3202,bovine,cow,hypernymy.1,15,0,15
3229,books,table,crossclassified,15,0,15
3320,goats,sheep,co-hyponymy,15,0,15
3276,man,traveler,co-hyponymy,15,15,0
4196,barn,building,hypernymy.2,15,9,6
5634,donut,sandwich,crossclassified,15,6,9
701,blender,container,crossclassified,15,15,0
1188,pizza,snakes,crossclassified,15,15,0
1040,sculpture,vase,crossclassified,15,0,15
5851,book,carpet,crossclassified,15,0,15
6533,cabinet,drawers,crossclassified,15,15,0
5525,seat,sofa,hypernymy.1,15,12,3
1201,bed,bunk,hypernymy.1,15,15,0
830,shirt,truck,crossclassified,15,0,15
1251,bed,dresser,crossclassified,15,2,13
7395,bed,suitcase,crossclassified,15,12,3
4317,bacon,food,hypernymy.2,15,9,6
5992,house,skateboarder,crossclassified,15,15,0
1509,cycle,motorcycle,crossclassified,15,0,15
6939,counter,microwave,crossclassified,15,5,10
4343,bottle,soda,crossclassified,15,3,12
5453,cabinet,window,crossclassified,15,12,3
5885,apartment,building,crossclassified,15,0,15
7237,bed,window,crossclassified,15,11,4
1228,bus,mirror,crossclassified,15,15,0
5129,boat,bus,crossclassified,15,4,11
1236,man,pants,crossclassified,15,14,1
6445,boy,kite,crossclassified,15,15,0
5543,plate,rice,crossclassified,15,0,15
5279,motorcycle,tire,crossclassified,15,15,0
5566,counter,paper,crossclassified,15,15,0
589,board,building,crossclassified,15,0,15
6069,cow,horn,crossclassified,15,15,0
6857,glider,plane,co-hyponymy,15,10,5
7306,plate,sauce,crossclassified,15,0,15
773,cloth,shirt,crossclassified,15,0,15
7511,building,wheel,crossclassified,15,15,0
4399,car,jacket,crossclassified,15,13,2
1081,bed,doll,crossclassified,15,15,0
5768,car,trunk,co-hyponymy,15,15,0
1547,desk,workspace,crossclassified,15,15,0
998,mug,vase,crossclassified,15,13,2
9148,vegetable,vegetables,synonymy,14,8,6
1998,horse,wood,crossclassified,14,14,0
1537,pan,wok,hypernymy.1,14,3,11
9278,bookshelf,cat,crossclassified,14,14,0
11819,couch,tile,crossclassified,14,14,0
1321,human,surfer,crossclassified,14,0,14
921,food,vegetable,hypernymy.1,14,13,1
1966,counter,vase,crossclassified,14,13,1
2248,blouse,woman,crossclassified,14,0,14
6469,chili,food,hypernymy.2,14,10,4
10452,doll,toy,hypernymy.2,14,0,14
3425,horse,racehorse,hypernymy.1,14,14,0
7142,cow,toy,crossclassified,14,14,0
923,bed,electronics,crossclassified,14,14,0
2538,banana,fruit,hypernymy.2,14,2,12
2805,bridge,truck,crossclassified,14,13,1
2802,boy,gamer,crossclassified,14,14,0
5966,roof,tent,crossclassified,14,6,8
4510,hut,shelter,hypernymy.2,14,11,3
5912,helmet,snowboarder,crossclassified,14,0,14
1809,neck,shirt,crossclassified,14,0,14
1810,box,pizza,crossclassified,14,4,10
1442,cardigan,shirt,crossclassified,14,0,14
10743,man,shirts,crossclassified,14,14,0
6062,boat,house,crossclassified,14,8,6
4661,chair,remote,crossclassified,14,3,11
581,desk,wall,crossclassified,14,14,0
808,arm,jacket,crossclassified,14,2,12
6043,shoe,table,crossclassified,14,0,14
7805,chair,plate,crossclassified,14,10,4
1769,table,wire,crossclassified,14,14,0
1399,dog,horse,crossclassified,14,5,9
3942,spoon,woman,crossclassified,14,0,14
4918,bullpen,dugout,crossclassified,14,0,14
13324,bow,hat,crossclassified,14,0,14
1381,meal,sandwich,crossclassified,14,0,14
436,donuts,table,crossclassified,14,0,14
7044,catcher,t-shirt,crossclassified,14,14,0
4950,queen,woman,crossclassified,14,14,0
1002,diner,woman,crossclassified,14,0,14
3596,boy,sweater,crossclassified,14,12,2
8978,cupcake,cupcakes,synonymy,14,0,14
9003,desk,papers,crossclassified,14,14,0
115,dog,t-shirt,crossclassified,14,14,0
13442,floor,toilet,co-hyponymy,14,14,0
1025,giraffe,head,crossclassified,14,14,0
3562,barbecue,grill,crossclassified,14,0,14
7593,mountain,snow,crossclassified,14,0,14
4102,meat,steak,hypernymy.1,14,4,10
4681,runway,tarmac,co-hyponymy,14,14,0
231,bench,rhombencephalon,crossclassified,14,14,0
2124,person,umpire,hypernymy.1,14,0,14
2995,door,doorway,synonymy,14,9,5
4424,armchair,couch,crossclassified,14,0,14
725,cake,cheesecake,hypernymy.1,14,14,0
2940,boat,sheep,crossclassified,14,14,0
2514,horse,man,hypernymy.2,14,10,4
3295,glass,wineglass,hypernymy.1,14,14,0
5730,pillow,rug,crossclassified,14,0,14
13819,flower,house,crossclassified,14,0,14
3291,mat,table,crossclassified,14,0,14
5428,animal,bull,hypernymy.1,14,2,12
2856,flannel,shirt,crossclassified,14,0,14
10267,curtain,toy,crossclassified,14,14,0
1628,bathroom,bathtub,crossclassified,14,0,14
2207,boy,doll,crossclassified,14,14,0
7267,soup,spoon,crossclassified,14,13,1
6526,bowl,dessert,crossclassified,14,14,0
13617,ham,meat,hypernymy.2,14,0,14
1610,ring,woman,crossclassified,14,0,14
9672,snacks,table,crossclassified,14,0,14
1280,bowl,oranges,crossclassified,14,14,0
9343,dandelion,flower,crossclassified,14,0,14
2178,man,racket,crossclassified,14,14,0
3109,counter,tray,crossclassified,14,11,3
5586,drinks,table,crossclassified,14,0,14
3115,table,vegetable,crossclassified,14,13,1
770,cycle,man,crossclassified,14,0,14
2527,dog,rope,crossclassified,14,14,0
656,bath,tub,synonymy,14,0,14
3137,container,tank,hypernymy.1,14,14,0
5729,rug,t-shirt,crossclassified,14,14,0
2984,man,women,co-hyponymy,14,14,0
2501,hut,shed,crossclassified,14,3,11
238,child,children,synonymy,13,13,0
2172,plate,tray,co-hyponymy,13,4,9
3079,door,dresser,crossclassified,13,8,5
1874,drawer,table,crossclassified,13,0,13
3658,cap,snowboarder,crossclassified,13,0,13
7796,couch,wire,crossclassified,13,13,0
1394,arch,bridge,co-hyponymy,13,0,13
1849,counter,orange,crossclassified,13,13,0
3677,curtain,sheet,crossclassified,13,13,0
3679,soup,stew,co-hyponymy,13,13,0
1453,box,cat,crossclassified,13,5,8
3830,carpet,chairs,crossclassified,13,13,0
2981,horse,wheel,crossclassified,13,13,0
3818,helmet,motorcycle,crossclassified,13,0,13
3807,family,man,crossclassified,13,0,13
2667,desk,screen,crossclassified,13,13,0
403,crust,food,crossclassified,13,2,11
1825,jacket,pant,crossclassified,13,13,0
4784,athlete,catcher,hypernymy.1,13,0,13
4821,girl,goalie,crossclassified,13,10,3
7830,cap,cow,crossclassified,13,0,13
2985,apple,knife,crossclassified,13,0,13
7330,glass,glasses,synonymy,13,1,12
1169,food,lunch,hypernymy.1,13,13,0
391,child,toothbrush,crossclassified,13,13,0
10618,beach,woman,crossclassified,13,0,13
9341,dugout,pant,crossclassified,13,13,0
3107,bridge,tree,crossclassified,13,13,0
3342,pillow,woman,crossclassified,13,0,13
7423,bagel,bun,hypernymy.2,13,13,0
7465,booth,building,crossclassified,13,13,0
622,fruit,salad,crossclassified,13,1,12
301,bathtub,washbasin,crossclassified,13,13,0
3456,beard,jacket,crossclassified,13,2,11
3331,house,restaurant,co-hyponymy,13,1,12
1263,bird,kiwi,hypernymy.1,13,13,0
5290,brush,man,crossclassified,13,0,13
3633,blender,juicer,crossclassified,13,13,0
4257,burger,salad,crossclassified,13,0,13
3440,field,sheep,crossclassified,13,0,13
3423,shirt,strap,crossclassified,13,13,0
3845,dog,floor,crossclassified,13,5,8
9466,counter,vegetables,crossclassified,13,13,0
5804,cake,child,crossclassified,13,0,13
5359,desk,dog,crossclassified,13,12,1
5232,bagel,bread,hypernymy.2,13,13,0
1954,bridge,trestle,crossclassified,13,13,0
5155,books,bookshelf,crossclassified,13,0,13
3510,bridge,railroad,crossclassified,13,13,0
6025,catcher,shirt,crossclassified,13,13,0
7062,banana,curtain,crossclassified,13,0,13
10124,dresser,mirror,crossclassified,13,9,4
9342,dugout,shoe,crossclassified,13,13,0
7381,curtain,sofa,crossclassified,13,13,0
2881,pot,soup,crossclassified,13,10,3
751,tanker,truck,crossclassified,13,0,13
3581,counter,wall,crossclassified,13,10,3
7076,cat,plate,crossclassified,13,13,0
5455,drawer,dresser,crossclassified,13,0,13
1098,man,sweatshirt,crossclassified,13,12,1
9044,bow,bowtie,crossclassified,13,0,13
1233,man,student,crossclassified,13,13,0
615,skateboard,surfer,crossclassified,13,0,13
3514,man,singer,crossclassified,13,13,0
2083,dugout,player,crossclassified,13,13,0
2295,bread,croissant,hypernymy.1,13,0,13
3914,bed,glass,crossclassified,13,13,0
8069,cabbage,food,hypernymy.2,13,13,0
4160,aquarium,tank,hypernymy.2,13,13,0
1787,aircraft,jet,hypernymy.1,13,0,13
2377,table,wooden,crossclassified,13,13,0
2448,couple,person,crossclassified,13,13,0
1711,cap,shirt,crossclassified,13,0,13
14823,train,trepan,crossclassified,13,13,0
4630,curtain,sink,crossclassified,13,12,1
4290,remote,shirt,crossclassified,13,0,13
8261,floor,toy,crossclassified,13,13,0
4140,table,wine,crossclassified,13,13,0
11266,car,tyre,crossclassified,13,13,0
563,bird,chicken,hypernymy.1,13,10,3
1632,skater,skating,crossclassified,13,13,0
4383,floor,suitcase,crossclassified,13,7,6
8554,desk,shirt,crossclassified,13,8,5
1723,cyclist,woman,crossclassified,13,0,13
13243,container,yogurt,crossclassified,13,0,13
4170,eater,woman,crossclassified,13,0,13
6325,couch,toy,crossclassified,13,13,0
4666,pedestrian,woman,crossclassified,13,0,13
4194,building,elephant,crossclassified,13,2,11
2630,shirt,wire,crossclassified,13,13,0
4454,girl,pizza,crossclassified,13,13,0
4450,cabinet,kitchen,crossclassified,13,7,6
1792,sweater,t-shirt,crossclassified,13,13,0
1690,furniture,man,crossclassified,13,0,13
3872,desk,television,crossclassified,13,13,0
4459,board,skateboarder,crossclassified,13,0,13
893,bench,bicycle,crossclassified,13,13,0
6207,bowl,lettuce,crossclassified,13,3,10
4018,bridge,motorcycle,crossclassified,13,12,1
1797,carpet,wood,crossclassified,13,13,0
1618,chain,woman,crossclassified,13,0,13
7864,carpet,pillow,crossclassified,13,13,0
4178,canopy,curtain,crossclassified,12,0,12
3506,bowl,lid,crossclassified,12,12,0
1327,bridge,vehicle,crossclassified,12,12,0
7393,elephant,house,crossclassified,12,6,6
11255,bun,table,crossclassified,12,0,12
4058,dugout,stadium,crossclassified,12,12,0
2190,sauce,soup,crossclassified,12,5,7
613,skating,surfer,crossclassified,12,0,12
2578,button,shirt,crossclassified,12,0,12
4552,cake,chair,crossclassified,12,1,11
5751,dress,player,crossclassified,12,1,11
7704,dog,shoe,crossclassified,12,12,0
3194,bag,floor,crossclassified,12,0,12
12637,cakes,table,crossclassified,12,0,12
140,coat,robe,crossclassified,12,5,7
5092,plate,vegetable,crossclassified,12,9,3
8140,couch,pants,crossclassified,12,12,0
356,cottage,house,hypernymy.2,12,0,12
5490,canine,dog,hypernymy.1,12,0,12
5888,car,cow,crossclassified,12,3,9
1213,cat,remote,crossclassified,12,12,0
3539,t-shirt,tent,crossclassified,12,0,12
1585,airplane,areopagite,crossclassified,12,12,0
9633,donuts,food,hypernymy.2,12,10,2
3203,pullover,shirt,crossclassified,12,0,12
11407,chair,patio,crossclassified,12,0,12
628,head,horse,crossclassified,12,0,12
10473,cycle,truck,crossclassified,12,0,12
5788,house,tent,crossclassified,12,2,10
4100,bookshelf,table,crossclassified,12,10,2
1708,girl,teenager,crossclassified,12,12,0
13411,kettle,teapot,co-hyponymy,12,12,0
1556,blouse,jacket,crossclassified,12,0,12
4147,cellphone,table,crossclassified,12,0,12
1549,bridge,roadway,crossclassified,12,12,0
1702,bicycle,bridge,crossclassified,12,0,12
4462,jeep,vehicle,hypernymy.2,12,12,0
2334,gloves,man,crossclassified,12,0,12
1546,burger,donut,crossclassified,12,0,12
1063,model,woman,crossclassified,12,0,12
10378,table,wall,crossclassified,12,6,6
4130,surfer,water,crossclassified,12,12,0
1694,bike,bridge,crossclassified,12,0,12
2533,blender,juice,crossclassified,12,12,0
7173,cow,cows,synonymy,12,12,0
1979,bed,lamp,crossclassified,12,12,0
1712,meal,pizza,crossclassified,12,0,12
849,dress,flower,crossclassified,12,12,0
6477,fork,silverware,crossclassified,12,12,0
14401,food,oatmeal,hypernymy.1,12,0,12
4498,goat,man,co-hyponymy,12,1,11
455,blender,counter,crossclassified,12,0,12
3297,glass,wine,crossclassified,12,6,6
3465,curtain,pillow,crossclassified,12,12,0
5406,bowtie,jacket,crossclassified,12,0,12
9669,cat,man,hypernymy.2,12,4,8
3312,bench,umbrella,crossclassified,12,12,0
2034,sandwich,snack,crossclassified,12,12,0
4490,carpet,tile,crossclassified,12,12,0
1307,pizza,spoon,crossclassified,12,12,0
6548,cake,pan,crossclassified,12,4,8
4482,bathtub,shower,crossclassified,12,3,9
4072,cabinet,self,crossclassified,12,12,0
4083,cake,tray,crossclassified,12,7,5
7398,bottle,cabinet,crossclassified,12,7,5
3588,cat,toy,crossclassified,12,12,0
2497,handbag,woman,crossclassified,12,0,12
1277,bowl,tray,crossclassified,12,12,0
3924,clothes,robe,crossclassified,12,0,12
4304,door,van,crossclassified,12,10,2
4298,batter,girl,crossclassified,12,10,2
4791,car,man,crossclassified,12,9,3
4883,bird,falcon,hypernymy.1,12,12,0
9932,counter,display,crossclassified,12,12,0
8039,food,taco,hypernymy.1,12,1,11
4659,animal,carpet,crossclassified,12,0,12
7327,fork,knife,crossclassified,12,4,8
3699,floor,sofa,crossclassified,12,12,0
4879,batter,t-shirt,crossclassified,12,12,0
2300,chair,chaise,hypernymy.1,12,12,0
4777,electronics,man,crossclassified,12,0,12
7318,book,girl,crossclassified,12,0,12
4872,bicyclist,woman,crossclassified,12,0,12
3920,garfield,giraffe,crossclassified,12,0,12
15782,sailboat,ship,crossclassified,12,0,12
6838,animal,desk,crossclassified,12,0,12
1851,compartment,train,crossclassified,12,0,12
1850,sweatshirt,woman,crossclassified,12,0,12
2701,chopper,motorcycle,crossclassified,12,0,12
2699,chair,keyboard,crossclassified,12,12,0
7846,rug,toy,crossclassified,12,12,0
4786,stool,table,crossclassified,12,0,12
3708,bowl,woman,crossclassified,12,0,12
10108,poncho,shirt,crossclassified,12,0,12
8570,building,t-shirt,crossclassified,12,12,0
7006,bench,plate,crossclassified,12,8,4
7872,carpet,toy,crossclassified,12,12,0
3072,food,pancakes,hypernymy.1,12,0,12
2437,bottle,desk,crossclassified,12,0,12
1473,horse,wrap,crossclassified,12,12,0
2179,man,speaker,crossclassified,12,12,0
3959,snowboarder,t-shirt,crossclassified,12,12,0
10170,glass,motorcycle,crossclassified,12,0,12
3983,man,pilot,crossclassified,12,12,0
4602,jacket,purse,crossclassified,12,1,11
13225,curtain,statue,crossclassified,12,0,12
6664,carpet,legs,crossclassified,12,12,0
2182,cow,rope,crossclassified,12,12,0
4616,cake,waffle,hypernymy.1,12,0,12
2159,bellow,couch,crossclassified,12,0,12
7897,building,fence,crossclassified,12,12,0
6758,food,mustard,hypernymy.1,12,0,12
3967,man,monk,crossclassified,12,12,0
729,dress,top,co-hyponymy,12,12,0
6689,keyboard,man,crossclassified,12,0,12
8733,car,toy,crossclassified,12,12,0
1450,container,vase,hypernymy.1,12,0,12
1389,jacket,pizza,crossclassified,12,12,0
997,cat,television,crossclassified,12,12,0
1488,dough,pizza,crossclassified,12,0,12
1815,baker,woman,crossclassified,12,0,12
1621,jersey,t-shirt,synonymy,11,11,0
5615,girl,lady,co-hyponymy,11,11,0
1615,skateboarder,teenager,crossclassified,11,11,0
7508,bear,hat,crossclassified,11,0,11
4428,bun,shirt,crossclassified,11,0,11
916,couch,phone,crossclassified,11,11,0
9944,tracks,train,crossclassified,11,6,5
2954,cheese,sauce,crossclassified,11,8,3
2428,bread,counter,crossclassified,11,1,10
1173,doll,woman,hypernymy.2,11,0,11
3351,couch,family,crossclassified,11,11,0
3327,jacket,knife,crossclassified,11,11,0
4255,airplane,bomber,hypernymy.1,11,11,0
1152,desk,glass,crossclassified,11,11,0
4247,bed,cap,crossclassified,11,11,0
5562,house,wood,crossclassified,11,11,0
9525,ship,wall,crossclassified,11,0,11
5379,carpet,stage,crossclassified,11,11,0
6859,airplane,glider,co-hyponymy,11,8,3
1620,jersey,uniform,crossclassified,11,11,0
747,orange,table,crossclassified,11,0,11
5662,bear,cake,crossclassified,11,0,11
698,bag,shirt,crossclassified,11,0,11
498,carrot,food,hypernymy.2,11,3,8
2907,pants,skater,crossclassified,11,0,11
2069,motorcycle,trike,crossclassified,11,11,0
6698,light,vent,crossclassified,11,0,11
4362,stove,table,crossclassified,11,7,4
6876,ketchup,sauce,co-hyponymy,11,0,11
2498,barn,shed,crossclassified,11,7,4
3062,jacket,torso,crossclassified,11,11,0
5526,loveseat,sofa,hypernymy.2,11,0,11
2885,animals,giraffe,hypernymy.1,11,0,11
2080,belt,dugout,crossclassified,11,0,11
2494,bird,statue,crossclassified,11,3,8
5487,boy,hitter,crossclassified,11,11,0
10147,bricks,house,crossclassified,11,9,2
3233,friend,man,co-hyponymy,11,0,11
5452,banana,girl,crossclassified,11,0,11
2860,bridge,rail,crossclassified,11,11,0
2858,shirt,surfer,crossclassified,11,1,10
8057,cap,helmet,co-hyponymy,11,0,11
3286,hat,hood,co-hyponymy,11,7,4
2113,bridge,pul,crossclassified,11,11,0
2051,cabinet,stand,crossclassified,11,7,4
9544,restaurant,window,crossclassified,11,9,2
746,bird,wood,crossclassified,11,11,0
5719,rug,shoe,crossclassified,11,11,0
7204,bag,train,crossclassified,11,0,11
3304,man,tennis,crossclassified,11,11,0
5410,grill,hotdogs,crossclassified,11,11,0
5405,couch,jeans,crossclassified,11,11,0
5390,boat,deck,crossclassified,11,11,0
5552,bagel,plate,crossclassified,11,11,0
2116,bed,cushion,hypernymy.1,11,11,0
3869,trailer,train,crossclassified,11,0,11
2534,necklace,woman,crossclassified,11,0,11
798,dress,mobile,crossclassified,11,11,0
8527,dresser,wood,crossclassified,11,11,0
3968,pyjamas,shirt,crossclassified,11,0,11
4938,can,drink,crossclassified,11,11,0
4944,plat,table,crossclassified,11,0,11
3609,girl,keyboard,crossclassified,11,11,0
3978,fridge,refrigerator,hypernymy.2,11,0,11
1897,jacket,laptop,crossclassified,11,11,0
3593,girl,pitcher,crossclassified,11,9,2
4568,bun,pizza,crossclassified,11,1,10
1508,bag,chair,crossclassified,11,0,11
2575,bed,duvet,crossclassified,11,11,0
7888,truck,wood,crossclassified,11,11,0
2535,adult,woman,hypernymy.1,11,0,11
2738,bench,boat,crossclassified,11,0,11
5068,bridge,window,crossclassified,11,9,2
5074,flower,sunflower,hypernymy.1,11,11,0
10574,melon,watermelon,hypernymy.1,11,11,0
4515,hut,shack,synonymy,11,11,0
5086,girl,snowboarder,crossclassified,11,0,11
5119,airplane,man,crossclassified,11,7,4
1733,flowerpot,vase,crossclassified,11,0,11
449,batter,shirt,crossclassified,11,8,3
4642,bike,truck,co-hyponymy,11,0,11
4656,airplane,tarmac,crossclassified,11,11,0
3511,hotdog,snacks,crossclassified,11,11,0
6269,donut,doughnuts,synonymy,11,11,0
12858,bird,car,crossclassified,11,0,11
4670,broccoli,vegetable,hypernymy.2,11,11,0
824,plane,train,crossclassified,11,4,7
6126,bread,cheese,crossclassified,11,11,0
4707,hamster,mouse,co-hyponymy,11,11,0
6230,leg,person,crossclassified,11,6,5
6123,cap,truck,crossclassified,11,0,11
3901,cart,truck,hypernymy.1,11,6,5
10774,bridge,pool,crossclassified,11,11,0
7001,plant,wheat,hypernymy.1,11,11,0
15294,bananas,bowl,crossclassified,11,0,11
7806,bowl,vegetables,crossclassified,11,11,0
8797,gown,robe,synonymy,11,10,1
3906,quesadilla,sandwich,crossclassified,11,7,4
1846,counter,fruit,crossclassified,11,9,2
10639,cabinets,kitchen,crossclassified,11,2,9
6270,book,cat,crossclassified,11,0,11
3702,bowl,meat,crossclassified,11,9,2
3697,clydesdale,horse,hypernymy.2,11,0,11
4880,counter,tap,crossclassified,11,11,0
993,dress,uniform,co-hyponymy,11,11,0
7808,bench,cushion,crossclassified,11,11,0
13727,helmet,mask,crossclassified,11,0,11
795,dress,sleeveless,crossclassified,11,11,0
11882,store,storefront,crossclassified,11,0,11
1528,hand,jacket,crossclassified,11,0,11
452,bracelet,woman,crossclassified,11,0,11
5868,ball,dog,crossclassified,11,0,11
5277,soldier,woman,crossclassified,11,0,11
8411,bottle,bucket,co-hyponymy,11,0,11
5855,man,truck,crossclassified,11,0,11
9198,animal,rug,crossclassified,11,0,11
7620,glasses,table,crossclassified,11,0,11
5204,placeman,table,crossclassified,11,0,11
9219,outhouse,shed,co-hyponymy,11,10,1
7598,bathtub,counter,crossclassified,11,7,4
2809,blanket,chair,crossclassified,11,6,5
7946,chair,chairs,synonymy,11,11,0
5311,doll,hat,crossclassified,11,0,11
1298,dog,pet,crossclassified,11,11,0
620,helmet,skater,crossclassified,11,0,11
164,box,woman,crossclassified,11,0,11
2561,head,zebra,crossclassified,11,0,11
618,chair,coat,crossclassified,11,8,3
2370,car,door,crossclassified,11,8,3
7658,bowls,glass,co-hyponymy,11,0,11
3493,art,vase,crossclassified,11,0,11
1728,car,road,crossclassified,11,8,3
142,clothing,robe,hypernymy.1,11,0,11
2768,curtain,curter,crossclassified,11,11,0
10830,legs,person,crossclassified,10,10,0
6101,electronics,shirt,crossclassified,10,0,10
2522,cow,pole,crossclassified,10,10,0
10829,legs,pants,crossclassified,10,6,4
6206,bison,cow,crossclassified,10,0,10
6787,motorcycle,sidecar,crossclassified,10,2,8
6241,counter,man,co-hyponymy,10,4,6
2472,cap,skater,crossclassified,10,0,10
11326,airplane,skyline,crossclassified,10,0,10
11173,airplane,table,crossclassified,10,0,10
10885,microwave,table,crossclassified,10,0,10
5765,cap,train,crossclassified,10,0,10
7282,fruit,oranges,hypernymy.1,10,10,0
6108,counter,grill,crossclassified,10,5,5
966,giraffe,person,crossclassified,10,10,0
2695,house,jacket,crossclassified,10,9,1
1071,bench,legs,crossclassified,10,10,0
10828,drink,table,crossclassified,10,0,10
2658,boat,plane,crossclassified,10,4,6
2528,grandma,woman,crossclassified,10,0,10
1135,carrot,table,crossclassified,10,0,10
5654,beat,bed,crossclassified,10,0,10
6498,bench,bottle,crossclassified,10,10,0
2165,cupcake,frosting,crossclassified,10,10,0
7290,pant,tent,crossclassified,10,0,10
5785,board,bridge,crossclassified,10,0,10
5769,car,shoe,crossclassified,10,10,0
2941,cheese,salad,crossclassified,10,0,10
2945,gazebo,tent,crossclassified,10,0,10
918,food,roll,hypernymy.1,10,10,0
2402,cup,soda,crossclassified,10,10,0
6038,airbus,airplane,hypernymy.2,10,0,10
10925,glass,juice,crossclassified,10,10,0
833,controller,man,co-hyponymy,10,0,10
2796,food,salmon,hypernymy.1,10,5,5
6942,car,street,crossclassified,10,2,8
6550,backpack,woman,crossclassified,10,0,10
942,giraffe,statue,crossclassified,10,10,0
794,bathroom,sink,crossclassified,10,0,10
5940,couch,vase,crossclassified,10,7,3
5921,furniture,woman,crossclassified,10,0,10
779,athlete,pitcher,hypernymy.1,10,0,10
7236,bed,mirror,crossclassified,10,10,0
1110,shelter,tent,hypernymy.1,10,0,10
5918,carriage,horse,crossclassified,10,10,0
2364,pizza,spatula,crossclassified,10,2,8
2761,clothing,coat,hypernymy.1,10,0,10
6598,athlete,skier,hypernymy.1,10,0,10
14167,jar,juice,crossclassified,10,10,0
13995,dog,tub,crossclassified,10,1,9
5688,bridge,sign,co-hyponymy,10,9,1
6468,food,topping,crossclassified,10,10,0
10685,couch,plate,crossclassified,10,10,0
10454,bathtub,toy,crossclassified,10,0,10
1085,animal,boat,crossclassified,10,0,10
6483,path,sidewalk,hypernymy.1,10,0,10
2234,curtain,toilet,crossclassified,10,10,0
2239,coat,phone,crossclassified,10,10,0
11115,desk,vase,crossclassified,10,8,2
2348,curtain,jacket,crossclassified,10,6,4
5829,book,child,crossclassified,10,0,10
2213,train,tree,crossclassified,10,10,0
6317,chef,shirt,crossclassified,10,0,10
12119,chair,suitcase,crossclassified,10,5,5
2797,food,steak,hypernymy.1,10,7,3
2906,jeans,skater,crossclassified,10,0,10
8052,cake,muffin,crossclassified,10,9,1
12389,bed,daybed,crossclassified,10,10,0
5630,glass,skier,crossclassified,10,0,10
3791,floor,t-shirt,crossclassified,10,10,0
8941,boat,cap,crossclassified,10,10,0
7814,statue,woman,crossclassified,10,8,2
8862,boy,laptop,crossclassified,10,1,9
4868,curtain,television,crossclassified,10,10,0
13309,chicken,fish,crossclassified,10,0,10
4853,canister,jar,crossclassified,10,5,5
1840,house,tie,crossclassified,10,10,0
1437,child,skateboard,crossclassified,10,10,0
8783,cake,shoe,crossclassified,10,10,0
4668,building,hanger,crossclassified,10,10,0
15525,backpack,bag,hypernymy.2,10,10,0
1822,food,hamburger,hypernymy.1,10,8,2
3812,door,window,crossclassified,10,3,7
4705,gerbil,hamster,co-hyponymy,10,0,10
8730,bench,clothing,crossclassified,10,10,0
1456,toilet,tub,crossclassified,10,5,5
7853,baby,woman,hypernymy.2,10,0,10
8602,dog,doll,crossclassified,10,10,0
1398,boy,mobile,crossclassified,10,10,0
1393,bridge,ship,crossclassified,10,8,2
3648,chair,loveseat,crossclassified,10,10,0
5627,bottle,can,co-hyponymy,10,2,8
12578,counter,pant,crossclassified,10,10,0
5265,shorts,woman,crossclassified,10,0,10
1315,snakes,table,crossclassified,10,0,10
12608,child,highchair,crossclassified,10,0,10
3496,grill,pizza,crossclassified,10,9,1
5089,horse,toy,crossclassified,10,10,0
9038,car,table,crossclassified,10,8,2
3537,man,tent,crossclassified,10,0,10
1356,cape,dress,crossclassified,10,2,8
5026,cat,toilet,crossclassified,10,1,9
9015,ship,train,crossclassified,10,8,2
4981,bread,meat,crossclassified,10,7,3
1910,mouse,table,crossclassified,10,1,9
7749,bed,wall,hypernymy.1,10,5,5
1372,cupcakes,table,crossclassified,10,1,9
4960,man,patient,crossclassified,10,10,0
596,boat,woman,crossclassified,10,6,4
1795,airliner,plane,hypernymy.2,10,0,10
1475,hare,horse,crossclassified,10,0,10
304,seat,shirt,crossclassified,10,4,6
4377,car,sign,crossclassified,10,10,0
4443,dress,sari,hypernymy.1,10,10,0
473,couch,window,crossclassified,10,10,0
4431,greens,salad,crossclassified,10,0,10
4416,curtain,person,crossclassified,10,10,0
1668,child,doll,crossclassified,10,10,0
531,dresser,stand,co-hyponymy,10,10,0
8191,cookie,dessert,crossclassified,10,5,5
1659,jacket,top,crossclassified,10,10,0
7980,groom,man,crossclassified,10,0,10
1775,pizza,quesadilla,crossclassified,10,7,3
7984,girl,spoon,crossclassified,10,10,0
13175,boy,statue,crossclassified,10,1,9
4291,bumper,car,crossclassified,10,0,10
4221,bat,child,crossclassified,10,0,10
1626,sea,woman,crossclassified,10,0,10
4229,floor,skateboard,crossclassified,10,10,0
4232,shirt,train,crossclassified,10,0,10
505,buffet,table,hypernymy.2,10,0,10
1545,table,truck,crossclassified,10,2,8
8332,board,man,crossclassified,10,2,8
7951,house,net,crossclassified,10,10,0
8375,bottle,oil,crossclassified,10,10,0
4627,juice,woman,crossclassified,10,0,10
4601,walker,woman,crossclassified,10,0,10
8466,glass,water,crossclassified,10,0,10
4559,couch,couches,synonymy,10,10,0
1515,couple,human,crossclassified,10,10,0
4028,cow,shirt,crossclassified,10,7,3
1522,man,runner,crossclassified,10,10,0
450,batter,cap,crossclassified,10,10,0
1523,man,scatting,crossclassified,10,10,0
4497,goat,jacket,crossclassified,10,8,2
4493,carpet,dress,crossclassified,10,10,0
1713,onion,pizza,crossclassified,10,0,10
460,counter,mixer,crossclassified,10,10,0
1707,girl,phone,crossclassified,10,10,0
462,poncho,raincoat,crossclassified,10,10,0
4466,batter,dugout,crossclassified,10,0,10
1692,man,wire,crossclassified,10,10,0
1965,motorcycle,transportation,crossclassified,10,10,0
861,cabinet,cabinetry,crossclassified,10,10,0
1274,cat,sofa,crossclassified,10,10,0
3192,floor,wheel,crossclassified,10,6,4
3420,burger,cake,crossclassified,10,0,10
1155,dessert,pie,crossclassified,10,3,7
7470,foil,sandwich,crossclassified,10,0,10
3402,counter,pan,crossclassified,10,9,1
7613,belt,cat,crossclassified,10,0,10
1160,bed,canopy,crossclassified,10,10,0
1204,belt,cow,crossclassified,10,0,10
9825,grass,ground,crossclassified,10,5,5
5331,box,counter,crossclassified,10,0,10
3046,boat,lake,crossclassified,10,10,0
3047,boat,jacket,crossclassified,10,10,0
7583,hair,shirt,crossclassified,10,0,10
286,sandwich,tomato,crossclassified,10,10,0
2006,student,woman,crossclassified,10,0,10
3375,jeans,woman,crossclassified,10,0,10
3056,bed,wooden,crossclassified,10,10,0
5373,dog,husky,hypernymy.1,10,10,0
1177,cookie,donut,crossclassified,10,0,10
3301,bench,flower,crossclassified,10,10,0
5383,hands,shirt,crossclassified,10,0,10
1200,fruit,lemon,hypernymy.1,10,6,4
3424,table,tie,crossclassified,10,9,1
3264,chin,shirt,crossclassified,10,0,10
9598,cat,shelf,crossclassified,10,0,10
2968,sign,train,crossclassified,10,0,10
15099,pancakes,plate,crossclassified,10,10,0
1978,faucet,sink,crossclassified,10,0,10
3442,oven,smoker,crossclassified,10,10,0
5603,bench,deck,crossclassified,10,10,0
5589,curtain,vase,crossclassified,10,8,2
5303,food,hotdogs,hypernymy.1,10,4,6
7354,cake,house,crossclassified,10,9,1
3241,container,cup,hypernymy.1,10,1,9
3210,carpet,remote,crossclassified,9,9,0
2594,bowl,bread,crossclassified,9,6,3
7358,pitcher,vase,crossclassified,9,0,9
4126,chair,kid,crossclassified,9,9,0
8383,camera,curtain,crossclassified,9,8,1
4025,ledge,table,crossclassified,9,0,9
10257,dress,skateboarder,crossclassified,9,0,9
3148,bench,skateboard,crossclassified,9,9,0
6404,restaurant,shop,crossclassified,9,9,0
4477,arm,hand,crossclassified,9,7,2
4056,hood,windshield,crossclassified,9,8,1
6407,desk,window,crossclassified,9,9,0
10130,truck,trucks,synonymy,9,9,0
4509,boy,cellphone,crossclassified,9,9,0
10977,knife,spoon,crossclassified,9,7,2
11477,costume,shark,crossclassified,9,0,9
4590,fish,salmon,hypernymy.1,9,1,8
3150,man,rope,crossclassified,9,9,0
3999,costume,woman,crossclassified,9,0,9
6442,headlight,motorcycle,crossclassified,9,0,9
5507,picture,woman,crossclassified,9,0,9
5479,suit,tux,crossclassified,9,9,0
9635,donuts,doughnuts,synonymy,9,9,0
2547,booth,woman,crossclassified,9,9,0
7387,animal,bed,crossclassified,9,0,9
7255,girl,remote,crossclassified,9,9,0
5492,platform,sidewalk,crossclassified,9,9,0
3159,fish,stingray,hypernymy.1,9,0,9
11075,pole,tent,crossclassified,9,0,9
2569,entree,food,hypernymy.2,9,0,9
9202,kimono,robe,hypernymy.2,9,7,2
8368,boy,toy,crossclassified,9,9,0
5644,bench,tie,crossclassified,9,9,0
8087,bowl,fruits,crossclassified,9,9,0
4306,boat,submarine,crossclassified,9,9,0
6690,boat,wooden,crossclassified,9,9,0
11351,bench,cap,crossclassified,9,9,0
13182,house,stairs,crossclassified,9,9,0
8023,remote,rug,crossclassified,9,0,9
4219,bread,pastry,co-hyponymy,9,9,0
6822,shirt,toga,crossclassified,9,0,9
4310,floor,wood,crossclassified,9,9,0
6836,building,pillar,co-hyponymy,9,9,0
2449,fence,wall,hypernymy.1,9,9,0
4277,book,boy,crossclassified,9,0,9
10076,bathtub,shoe,crossclassified,9,9,0
2961,desk,t-shirt,crossclassified,9,9,0
4246,boy,sweatshirt,crossclassified,9,9,0
4270,cap,player,crossclassified,9,0,9
11365,costume,mask,crossclassified,9,0,9
4313,bear,shirt,crossclassified,9,2,7
4128,apron,man,crossclassified,9,0,9
4425,couch,doll,crossclassified,9,9,0
2529,cake,spoon,crossclassified,9,2,7
5541,cake,rice,crossclassified,9,0,9
6882,building,kite,crossclassified,9,7,2
9677,ball,house,crossclassified,9,0,9
7319,girl,pant,crossclassified,9,9,0
9784,church,house,crossclassified,9,0,9
3976,cooler,refrigerator,hypernymy.2,9,0,9
13922,food,omelette,hypernymy.1,9,9,0
5573,knife,spatula,crossclassified,9,3,6
4173,curtain,tent,crossclassified,9,1,8
2937,bowl,nuts,crossclassified,9,9,0
6585,man,potter,crossclassified,9,9,0
4188,grass,sheep,crossclassified,9,0,9
3009,bottle,whiskey,crossclassified,9,9,0
9933,burger,counter,crossclassified,9,0,9
7983,cats,couch,crossclassified,9,0,9
8503,motorcycle,person,crossclassified,9,7,2
11598,bed,pant,crossclassified,9,9,0
5468,zebra,zipper,crossclassified,9,9,0
5916,buggy,carriage,hypernymy.2,9,0,9
10616,carpet,tie,crossclassified,9,9,0
13665,beef,meat,hypernymy.2,9,0,9
2742,hotdog,sub,co-hyponymy,9,9,0
5929,desk,mug,crossclassified,9,9,0
13415,bench,stool,co-hyponymy,9,9,0
2823,bowl,dinner,crossclassified,9,9,0
3569,clothing,sweater,hypernymy.1,9,0,9
5945,jacket,watch,crossclassified,9,9,0
3572,chicken,meat,hypernymy.2,9,2,7
9009,backpack,man,crossclassified,9,0,9
4979,cat,counter,crossclassified,9,0,9
7730,cup,plate,co-hyponymy,9,8,1
7755,blanket,cloth,crossclassified,9,9,0
4961,bucket,container,hypernymy.2,9,9,0
7056,house,mirror,crossclassified,9,9,0
6021,food,pretzel,hypernymy.1,9,0,9
7539,closet,door,co-hyponymy,9,0,9
3412,dancer,woman,crossclassified,9,0,9
11799,bird,chair,crossclassified,9,1,8
9510,couple,jacket,crossclassified,9,7,2
10469,blanket,elephant,crossclassified,9,8,1
14459,shirt,tress,crossclassified,9,9,0
5244,pants,skateboarder,crossclassified,9,0,9
7627,shirt,turtleneck,hypernymy.1,9,9,0
5887,dress,horse,crossclassified,9,1,8
5174,belt,jacket,crossclassified,9,0,9
2787,bike,van,crossclassified,9,0,9
2807,chair,paper,crossclassified,9,9,0
2784,cake,cat,crossclassified,9,7,2
7110,bowl,couch,crossclassified,9,0,9
2778,curtain,girl,crossclassified,9,9,0
7106,broccoli,rice,crossclassified,9,0,9
5910,man,mike,crossclassified,9,9,0
9117,bench,railing,crossclassified,9,9,0
7672,bench,coat,crossclassified,9,9,0
9108,blackberry,phone,crossclassified,9,0,9
5102,apple,woman,crossclassified,9,0,9
7708,bridge,shoe,crossclassified,9,9,0
9471,bag,car,crossclassified,9,0,9
12749,birdbath,fountain,crossclassified,9,9,0
3947,river,water,hypernymy.2,9,0,9
11655,man,prisoner,crossclassified,9,9,0
2659,food,patty,hypernymy.1,9,9,0
8744,pizza,soup,co-hyponymy,9,0,9
3245,boy,skating,crossclassified,9,9,0
8702,motorcycle,windshield,crossclassified,9,9,0
4701,minivan,van,hypernymy.2,9,0,9
5759,guy,woman,crossclassified,9,0,9
3846,cheese,table,crossclassified,9,0,9
2874,pant,person,crossclassified,9,0,9
2631,pasta,plate,crossclassified,9,9,0
3448,lettuce,sandwich,crossclassified,9,0,9
5752,hair,hat,crossclassified,9,0,9
4667,building,hangar,co-hyponymy,9,9,0
3885,biscuit,bread,hypernymy.2,9,8,1
5735,man,men,synonymy,9,9,0
3913,boat,mirror,crossclassified,9,9,0
2877,kid,person,hypernymy.2,9,0,9
6314,cabin,shed,crossclassified,9,0,9
5437,dugout,sidelines,crossclassified,9,9,0
7852,chair,teddy,crossclassified,9,9,0
3703,bench,grass,crossclassified,9,6,3
9565,diver,man,crossclassified,9,0,9
3337,cabinet,shelves,crossclassified,9,9,0
12762,food,muffin,hypernymy.1,9,0,9
7484,curtains,window,crossclassified,9,5,4
3705,dress,frock,synonymy,9,9,0
4861,desert,shirt,crossclassified,9,0,9
12771,jacket,orange,crossclassified,9,9,0
2686,counter,kitchenettes,crossclassified,9,9,0
2685,counter,rack,crossclassified,9,9,0
5395,food,snack,hypernymy.1,9,9,0
7002,plant,pot,crossclassified,9,1,8
4822,goalie,man,crossclassified,9,1,8
3290,visor,woman,crossclassified,9,0,9
14133,bowls,food,crossclassified,9,0,9
2672,desk,drawer,crossclassified,9,9,0
5434,sheep,wool,crossclassified,9,9,0
9548,cart,vehicle,hypernymy.2,9,2,7
8770,bed,pet,crossclassified,9,9,0
4925,bridge,t-shirt,crossclassified,9,9,0
5668,bowl,snack,crossclassified,9,9,0
1570,court,shirt,crossclassified,9,0,9
973,sandwich,wrap,hypernymy.1,9,4,5
519,burger,jacket,crossclassified,9,0,9
1992,cake,doll,crossclassified,9,9,0
516,airplane,engine,crossclassified,9,9,0
776,desk,stand,co-hyponymy,9,9,0
562,bird,chick,synonymy,9,9,0
1977,airplane,boat,crossclassified,9,4,5
948,harbor,marina,crossclassified,9,0,9
1266,cabinet,pantry,crossclassified,9,9,0
610,kid,surfer,crossclassified,9,0,9
1598,pita,pizza,crossclassified,9,0,9
1320,bird,tree,crossclassified,9,9,0
819,paganini,sandwich,crossclassified,9,0,9
1588,animal,toy,hypernymy.1,9,5,4
1843,giraffe,leaf,crossclassified,9,9,0
495,carrot,vegetables,hypernymy.2,9,8,1
1205,cow,ox,co-hyponymy,9,9,0
976,food,wrap,hypernymy.1,9,7,2
2153,dress,knife,crossclassified,9,9,0
1857,controller,shirt,crossclassified,9,0,9
1986,bird,wings,crossclassified,9,9,0
2131,tie,umbrella,crossclassified,9,0,9
887,light,streetlight,crossclassified,9,1,8
818,pastry,sandwich,crossclassified,9,0,9
858,horse,wooden,crossclassified,9,9,0
72,dugout,pants,crossclassified,9,9,0
1574,beer,drink,hypernymy.2,9,6,3
734,boat,pul,crossclassified,9,9,0
1647,seat,toilet,crossclassified,9,0,9
1446,decoration,vase,crossclassified,9,0,9
827,cake,candle,crossclassified,9,9,0
737,counter,top,crossclassified,9,9,0
187,farmer,man,crossclassified,9,0,9
1972,child,infant,hypernymy.1,9,9,0
1105,floor,mat,crossclassified,9,9,0
1894,belt,woman,crossclassified,9,0,9
4288,floor,tie,crossclassified,8,5,3
1317,bridge,highway,crossclassified,8,8,0
4015,sunglass,woman,crossclassified,8,0,8
2724,child,pant,crossclassified,8,8,0
4817,surfboard,surfer,crossclassified,8,0,8
9541,bar,restaurant,crossclassified,8,0,8
1591,train,woman,crossclassified,8,5,3
4793,belt,car,crossclassified,8,0,8
2697,giraffe,man,crossclassified,8,0,8
6809,suit,uniform,crossclassified,8,8,0
2005,bench,seating,crossclassified,8,8,0
974,burrito,wrap,crossclassified,8,4,4
7784,board,house,crossclassified,8,0,8
5179,bird,egret,hypernymy.1,8,8,0
13336,duck,toy,crossclassified,8,0,8
6171,bird,raven,hypernymy.1,8,8,0
6164,appetizer,food,hypernymy.2,8,0,8
2715,boy,coat,crossclassified,8,8,0
4006,batter,jersey,crossclassified,8,8,0
9066,pants,shoe,crossclassified,8,4,4
1438,carpet,flooring,crossclassified,8,8,0
9524,boat,wall,crossclassified,8,2,6
2299,chair,lounge,co-hyponymy,8,8,0
869,child,hair,crossclassified,8,4,4
10845,bottle,couch,crossclassified,8,0,8
5237,car,roof,crossclassified,8,8,0
3991,brownie,cake,hypernymy.2,8,0,8
8292,castle,ruins,crossclassified,8,8,0
7965,field,horse,crossclassified,8,5,3
6000,desk,remote,crossclassified,8,8,0
7667,bagel,burger,crossclassified,8,8,0
6927,boy,student,crossclassified,8,8,0
4755,shelf,shelving,crossclassified,8,8,0
621,salad,tomato,crossclassified,8,8,0
8346,arm,table,crossclassified,8,0,8
3656,kid,snowboarder,crossclassified,8,0,8
202,boy,glass,crossclassified,8,8,0
4744,sofa,window,crossclassified,8,0,8
8987,desk,keyboards,crossclassified,8,8,0
5283,building,truck,crossclassified,8,3,5
11565,cameraman,man,crossclassified,8,0,8
2632,noodles,pasta,hypernymy.2,8,0,8
10961,counter,keyboard,crossclassified,8,8,0
3069,pancakes,sandwich,crossclassified,8,8,0
6962,boat,railing,crossclassified,8,8,0
2656,book,jacket,crossclassified,8,0,8
2126,shoe,umpire,crossclassified,8,0,8
6077,bench,cycle,crossclassified,8,8,0
2327,bed,clothing,crossclassified,8,8,0
13087,raft,surfboard,crossclassified,8,0,8
6065,counter,pot,crossclassified,8,8,0
10202,bowl,ramekin,co-hyponymy,8,8,0
1886,hat,pillow,crossclassified,8,0,8
7753,man,sea,crossclassified,8,8,0
2676,beverage,cup,hypernymy.1,8,0,8
5158,food,quesadilla,hypernymy.1,8,3,5
9556,camera,desk,crossclassified,8,0,8
2673,cupboard,desk,crossclassified,8,0,8
1445,ornament,vase,crossclassified,8,0,8
9031,boat,window,crossclassified,8,8,0
9026,boat,boats,synonymy,8,8,0
3041,carrot,pot,crossclassified,8,0,8
5252,apples,bucket,crossclassified,8,0,8
6903,pants,woman,crossclassified,8,0,8
2010,juggler,man,crossclassified,8,0,8
5259,bike,house,crossclassified,8,0,8
3395,chair,lounger,hypernymy.1,8,8,0
5261,sink,washroom,crossclassified,8,8,0
5157,food,salsa,hypernymy.1,8,8,0
173,floor,flooring,synonymy,8,8,0
2837,burger,meat,crossclassified,8,2,6
938,counter,spoon,crossclassified,8,7,1
1973,skateboarder,teen,crossclassified,8,8,0
6431,cow,cube,crossclassified,8,8,0
134,platform,train,crossclassified,8,2,6
4223,child,pizza,crossclassified,8,8,0
2229,olive,pizza,crossclassified,8,0,8
12550,baby,crib,crossclassified,8,0,8
2171,cat,wheel,crossclassified,8,8,0
6457,sink,wood,crossclassified,8,8,0
4118,floor,ground,hypernymy.2,8,8,0
1625,skating,woman,crossclassified,8,0,8
3530,airport,plane,crossclassified,8,0,8
5050,beach,bridge,crossclassified,8,6,2
4892,desk,food,crossclassified,8,8,0
6366,giraffe,tent,crossclassified,8,8,0
6364,giraffe,shed,crossclassified,8,8,0
5058,foods,woman,crossclassified,8,0,8
4135,couch,men,crossclassified,8,8,0
6462,dress,overalls,crossclassified,8,8,0
6771,fish,toy,crossclassified,8,8,0
3468,athlete,bat,crossclassified,8,5,3
7959,bookshelf,bookshelves,synonymy,8,8,0
10540,balloon,pig,crossclassified,8,0,8
3482,counter,window,crossclassified,8,8,0
9319,carpet,motorcycle,crossclassified,8,2,6
4983,broccoli,meat,crossclassified,8,0,8
1676,bird,emu,hypernymy.1,8,8,0
4195,building,shelter,co-hyponymy,8,4,4
9262,bench,chairs,co-hyponymy,8,8,0
3463,dress,own,crossclassified,8,8,0
6596,train,van,crossclassified,8,3,5
4205,cabinetry,counter,crossclassified,8,0,8
6472,coleslaw,food,hypernymy.2,8,7,1
11825,book,chair,crossclassified,8,0,8
6577,giraffe,toy,crossclassified,8,8,0
6583,camera,cat,crossclassified,8,0,8
2912,cookie,pizza,crossclassified,8,0,8
10581,bench,camera,crossclassified,8,8,0
6471,food,relish,hypernymy.1,8,1,7
7845,door,woman,crossclassified,8,0,8
6358,canopy,roof,crossclassified,8,2,6
10394,class,cup,crossclassified,8,0,8
6249,dress,motorcycle,crossclassified,8,2,6
1725,bicycle,woman,crossclassified,8,0,8
6260,man,musician,crossclassified,8,8,0
13143,dress,laptop,crossclassified,8,8,0
5127,jacket,surfer,crossclassified,8,0,8
2979,girlfriend,woman,hypernymy.2,8,0,8
7817,bench,stone,crossclassified,8,8,0
6744,clothing,skater,crossclassified,8,0,8
4272,bat,player,crossclassified,8,2,6
11937,flowerpot,table,crossclassified,8,0,8
6344,scissors,shirt,crossclassified,8,0,8
4049,donut,snakes,crossclassified,8,8,0
8979,cupcakes,food,hypernymy.2,8,8,0
2746,boat,trawler,crossclassified,8,8,0
6224,boy,brush,crossclassified,8,8,0
2987,dress,tie,crossclassified,8,7,1
880,lamppost,streetlight,crossclassified,8,0,8
11942,rug,shirt,crossclassified,8,8,0
879,man,playing,crossclassified,8,8,0
8117,cabinet,wall,crossclassified,8,5,3
4269,helmet,player,crossclassified,8,0,8
961,cap,table,crossclassified,8,0,8
1710,pant,shirt,co-hyponymy,8,0,8
4256,banana,couch,crossclassified,8,0,8
2950,shirt,tent,crossclassified,8,0,8
2951,wire,woman,crossclassified,8,0,8
14884,plate,strawberry,crossclassified,8,0,8
12560,balls,table,crossclassified,8,0,8
1989,mouth,shirt,crossclassified,8,0,8
6308,curtain,laptop,crossclassified,8,8,0
4107,plant,stems,crossclassified,8,8,0
13862,bull,statue,crossclassified,8,0,8
6297,surfer,wave,crossclassified,8,0,8
9192,car,cycle,co-hyponymy,8,8,0
3409,body,man,crossclassified,8,0,8
6711,cellphone,desk,crossclassified,8,0,8
3550,scooter,vehicle,hypernymy.2,8,7,1
2772,chair,wooden,crossclassified,8,8,0
4088,sweet,table,crossclassified,8,0,8
3404,food,tomato,hypernymy.1,8,8,0
583,desk,office,crossclassified,8,8,0
7972,shirt,sling,crossclassified,8,8,0
2524,table,tile,crossclassified,8,8,0
1474,harness,horse,crossclassified,8,0,8
4651,carpet,lore,crossclassified,8,8,0
1101,plate,spoon,co-hyponymy,8,2,6
12951,grill,sausages,crossclassified,8,8,0
4597,pole,truck,crossclassified,8,0,8
5601,hotdog,paper,crossclassified,8,8,0
5766,carpet,mirror,crossclassified,8,4,4
12277,suitcase,train,crossclassified,8,0,8
3200,boy,burger,crossclassified,8,8,0
3285,dog,tie,crossclassified,8,8,0
5393,curtain,tile,crossclassified,8,8,0
2548,booth,table,hypernymy.2,8,6,2
1069,bench,person,crossclassified,8,8,0
5391,boat,shoe,crossclassified,8,8,0
8748,ramp,shoe,crossclassified,8,8,0
8522,donut,snacks,crossclassified,8,8,0
1847,apple,counter,crossclassified,8,0,8
1150,desk,tie,crossclassified,8,8,0
11090,bug,insect,hypernymy.2,8,8,0
4584,counter,foods,crossclassified,8,8,0
12136,floor,motorcycle,crossclassified,8,0,8
2407,shopper,woman,crossclassified,8,0,8
5587,curtain,glass,crossclassified,8,8,0
5793,cloth,jacket,crossclassified,8,0,8
9764,keyboard,woman,crossclassified,8,0,8
1559,jeans,man,crossclassified,8,0,8
9767,cow,dress,crossclassified,8,8,0
7063,bricks,building,crossclassified,8,5,3
3121,motorcycle,motorcyclist,crossclassified,8,8,0
2567,eggs,food,hypernymy.2,8,0,8
8637,sweater,vest,co-hyponymy,8,3,5
42,oven,woman,crossclassified,8,0,8
2381,airplane,bridge,crossclassified,8,0,8
1818,gloves,woman,crossclassified,8,0,8
5741,train,tramcar,crossclassified,8,8,0
3271,gyro,sandwich,hypernymy.2,8,0,8
9931,counter,sandwich,crossclassified,8,8,0
3178,bear,cupcake,crossclassified,8,0,8
8592,canister,cup,co-hyponymy,8,4,4
9940,caramel,sauce,crossclassified,8,0,8
5478,rug,sheet,crossclassified,8,8,0
1137,tractor,vehicle,hypernymy.2,8,8,0
5657,carpet,luggage,crossclassified,8,8,0
1212,airplane,car,crossclassified,8,6,2
2507,shack,shed,crossclassified,8,0,8
7424,cup,water,crossclassified,8,2,6
3169,railway,train,crossclassified,8,0,8
775,books,desk,crossclassified,8,0,8
221,back,shirt,crossclassified,8,0,8
1118,keyboard,shirt,crossclassified,8,0,8
3743,meat,pizza,crossclassified,8,4,4
9912,glasses,hat,crossclassified,8,0,8
12794,chicken,sandwich,crossclassified,8,0,8
3263,shirt,undershirt,crossclassified,8,8,0
4610,couch,people,crossclassified,8,8,0
9754,bear,cookie,crossclassified,8,0,8
8772,cabinet,knob,crossclassified,8,8,0
8546,girl,scissor,crossclassified,8,8,0
2087,cat,wooden,crossclassified,8,8,0
3940,parent,woman,crossclassified,8,0,8
12942,rhubarb,vegetables,hypernymy.2,8,8,0
5621,bear,dress,crossclassified,8,0,8
3732,baby,cake,crossclassified,8,8,0
1814,house,mansion,synonymy,8,8,0
8493,bed,pole,crossclassified,8,8,0
7064,woman,wood,crossclassified,8,8,0
4680,road,runway,crossclassified,8,0,8
2117,bed,remote,crossclassified,8,8,0
1162,cabinet,cat,crossclassified,8,7,1
4704,animal,hamster,hypernymy.1,8,0,8
8645,floor,mirror,crossclassified,8,3,5
4569,car,dogs,crossclassified,8,8,0
8957,bathroom,cabinet,crossclassified,8,0,8
3087,chocolate,donut,crossclassified,8,0,8
2033,friend,woman,crossclassified,8,0,8
7303,counter,tomato,crossclassified,8,8,0
11532,cabinet,vase,crossclassified,8,0,8
9824,ground,sidewalk,crossclassified,8,7,1
2440,donut,woman,crossclassified,8,0,8
9822,boy,sea,crossclassified,8,8,0
10084,couch,glass,crossclassified,8,8,0
7614,fur,sheep,crossclassified,8,0,8
11328,city,skyline,crossclassified,8,0,8
727,swimmer,woman,crossclassified,8,0,8
10089,fighter,plane,hypernymy.2,8,0,8
1034,carrot,knife,crossclassified,8,0,8
8382,container,truck,hypernymy.1,8,0,8
1872,rack,table,crossclassified,8,0,8
2028,burger,cheeseburger,hypernymy.1,8,8,0
3939,giraffe,giraffes,synonymy,8,8,0
5939,couch,flower,crossclassified,8,8,0
7301,cake,chocolate,crossclassified,8,8,0
3671,bed,computer,crossclassified,8,8,0
369,bat,dress,crossclassified,8,0,8
1021,chair,clothing,crossclassified,8,8,0
12868,teepee,tent,hypernymy.2,8,8,0
11343,flag,kite,crossclassified,8,0,8
3669,bed,luggage,crossclassified,8,8,0
1562,bridge,mirror,crossclassified,8,8,0
1218,boy,frisbee,crossclassified,8,8,0
3313,food,snacks,hypernymy.1,8,8,0
4699,server,spatula,crossclassified,8,0,8
2573,carpet,wall,crossclassified,8,8,0
211,bathroom,toilet,synonymy,8,0,8
7036,glass,pitcher,co-hyponymy,8,4,4
15662,buns,grill,crossclassified,8,0,8
2104,grill,stove,crossclassified,8,8,0
5827,spoon,vegetables,crossclassified,8,8,0
7026,building,patio,crossclassified,8,8,0
2425,bread,tomato,crossclassified,8,8,0
4693,bread,pancake,crossclassified,8,0,8
7021,flatbed,truck,crossclassified,8,0,8
4495,automobile,train,crossclassified,7,0,7
3235,bird,leaf,crossclassified,7,7,0
4936,dish,table,crossclassified,7,0,7
4185,foal,horse,crossclassified,7,0,7
3234,drinks,man,crossclassified,7,0,7
7280,blade,knife,co-hyponymy,7,0,7
13505,furniture,truck,crossclassified,7,0,7
10441,bridge,sheep,crossclassified,7,2,5
7165,scatting,skater,crossclassified,7,0,7
7921,building,parliament,crossclassified,7,7,0
12481,tire,wheel,crossclassified,7,7,0
7904,belt,bench,crossclassified,7,0,7
1520,couple,people,crossclassified,7,7,0
4251,hair,head,crossclassified,7,7,0
6607,arm,chair,crossclassified,7,0,7
1643,flower,woman,crossclassified,7,0,7
9835,costume,man,crossclassified,7,0,7
11811,bowl,pizza,crossclassified,7,4,3
4564,cow,house,crossclassified,7,1,6
4260,building,wooden,crossclassified,7,7,0
15154,horse,tent,crossclassified,7,0,7
6636,lemon,orange,co-hyponymy,7,7,0
4472,child,toilet,crossclassified,7,7,0
11886,storefront,window,crossclassified,7,4,3
1495,airplane,fuselage,crossclassified,7,7,0
13930,kite,whale,crossclassified,7,7,0
4489,cheese,toppings,crossclassified,7,7,0
7215,apples,plate,crossclassified,7,0,7
4957,bed,frame,crossclassified,7,7,0
1524,jacket,ring,crossclassified,7,7,0
10422,cat,glass,crossclassified,7,7,0
4896,bed,cloth,co-hyponymy,7,7,0
4226,glider,kite,crossclassified,7,4,3
687,pitcher,shirt,crossclassified,7,6,1
1527,human,jacket,crossclassified,7,0,7
3469,athlete,person,hypernymy.2,7,4,3
7892,building,picture,crossclassified,7,7,0
7865,bear,dog,crossclassified,7,6,1
4554,chair,statue,crossclassified,7,7,0
3260,car,person,crossclassified,7,6,1
4217,shuttle,train,co-hyponymy,7,0,7
6568,ship,yacht,co-hyponymy,7,7,0
6543,helmet,shirt,crossclassified,7,1,6
10453,toy,tub,crossclassified,7,7,0
9325,bowl,cake,crossclassified,7,6,1
1627,bathtub,tap,crossclassified,7,7,0
13917,chair,watch,crossclassified,7,7,0
3430,desk,pizza,crossclassified,7,6,1
283,dalmatian,dog,hypernymy.2,7,0,7
629,engine,truck,crossclassified,7,0,7
4876,batter,hat,crossclassified,7,7,0
4778,chili,hotdog,crossclassified,7,5,2
6884,building,kites,crossclassified,7,7,0
7543,cup,salad,crossclassified,7,7,0
7533,door,wardrobe,crossclassified,7,7,0
3033,child,surfer,crossclassified,7,2,5
3031,paper,sandwich,crossclassified,7,0,7
1455,bed,blankets,hypernymy.1,7,7,0
253,pier,railing,crossclassified,7,7,0
7039,building,mirror,crossclassified,7,7,0
2044,bottle,pizza,crossclassified,7,6,1
7531,hotdog,woman,crossclassified,7,0,7
6879,boy,face,crossclassified,7,7,0
850,biscuit,food,hypernymy.2,7,5,2
2046,cow,grass,crossclassified,7,4,3
13755,benches,pews,hypernymy.1,7,7,0
4677,pasta,pizza,co-hyponymy,7,0,7
12380,bench,log,crossclassified,7,7,0
1551,boy,hair,crossclassified,7,7,0
7774,bat,shoe,crossclassified,7,5,2
13669,banana,boy,crossclassified,7,0,7
3311,bench,car,crossclassified,7,3,4
3105,face,person,hypernymy.2,7,6,1
229,bird,gull,hypernymy.1,7,7,0
7752,chair,tent,crossclassified,7,0,7
626,bird,water,crossclassified,7,7,0
4373,grandpa,man,crossclassified,7,0,7
4730,butterfly,moth,co-hyponymy,7,7,0
3067,car,headlight,crossclassified,7,7,0
3060,cow,curtain,crossclassified,7,1,6
7626,car,vehicles,hypernymy.2,7,7,0
7629,sink,top,crossclassified,7,7,0
7572,jeep,wheel,crossclassified,7,7,0
9591,dog,hose,crossclassified,7,0,7
7563,trough,tub,crossclassified,7,7,0
3356,man,tourist,crossclassified,7,7,0
1577,boy,infant,crossclassified,7,7,0
3089,carrot,umbrella,crossclassified,7,0,7
7009,bottle,boy,crossclassified,7,0,7
7013,lunch,table,crossclassified,7,0,7
9656,bat,bench,crossclassified,7,0,7
7699,kettle,pot,hypernymy.2,7,4,3
4703,hamster,rodent,hypernymy.2,7,7,0
9661,furniture,sink,crossclassified,7,0,7
7490,bottle,chair,crossclassified,7,0,7
7787,car,umbrella,crossclassified,7,7,0
4664,cat,woman,hypernymy.2,7,1,6
6810,suit,t-shirt,crossclassified,7,7,0
7128,bowl,potatoes,crossclassified,7,7,0
6734,scoreboard,sign,hypernymy.2,7,7,0
7432,carpet,keyboard,crossclassified,7,7,0
15746,building,skateboard,crossclassified,7,7,0
4632,tennis,woman,crossclassified,7,0,7
2977,chain,dress,crossclassified,7,0,7
7138,nun,woman,crossclassified,7,0,7
9730,people,truck,crossclassified,7,0,7
10328,airplane,t-shirt,crossclassified,7,7,0
7148,pizza,spinach,crossclassified,7,7,0
1425,bridge,freeway,crossclassified,7,7,0
15794,leek,vegetables,hypernymy.2,7,7,0
1611,bench,bird,crossclassified,7,7,0
11919,bidet,sink,crossclassified,7,7,0
7155,bananas,plant,hypernymy.2,7,0,7
3171,box,food,crossclassified,7,2,5
4263,animal,lion,hypernymy.1,7,0,7
10360,tree,zebra,crossclassified,7,0,7
885,pole,streetlight,crossclassified,7,5,2
7127,baby,t-shirt,crossclassified,7,2,5
4641,bird,rain,crossclassified,7,7,0
13486,jacket,wheel,crossclassified,7,7,0
1996,bridge,man,crossclassified,7,6,1
9511,couple,suit,crossclassified,7,7,0
4662,book,man,crossclassified,7,0,7
3284,noodles,soup,crossclassified,7,0,7
1541,pan,salad,crossclassified,7,4,3
13485,jacket,skateboard,crossclassified,7,7,0
10269,curtain,doll,crossclassified,7,7,0
7088,house,kite,crossclassified,7,7,0
13799,clock,pizza,crossclassified,7,0,7
4274,bread,shirt,crossclassified,7,0,7
2140,bear,table,crossclassified,7,0,7
1994,bed,door,crossclassified,7,3,4
10295,hat,headdress,hypernymy.2,7,7,0
4833,cow,giraffe,crossclassified,7,1,6
3149,bench,pants,crossclassified,7,7,0
786,car,minivan,hypernymy.1,7,7,0
3151,apple,man,crossclassified,7,0,7
2986,hand,knife,crossclassified,7,0,7
7109,couch,cup,crossclassified,7,7,0
3783,shoe,wall,crossclassified,7,0,7
10613,curtain,wood,crossclassified,7,7,0
9818,fence,table,crossclassified,7,0,7
13080,cat,rack,crossclassified,7,0,7
5426,cat,pet,crossclassified,7,7,0
3998,jacket,sandwich,crossclassified,7,7,0
14119,shower,window,crossclassified,7,7,0
8256,counter,mirror,crossclassified,7,7,0
3992,table,window,crossclassified,7,6,1
9047,face,toy,crossclassified,7,0,7
3631,boy,truck,crossclassified,7,2,5
5734,man,net,co-hyponymy,7,7,0
6064,hotdog,tomato,crossclassified,7,7,0
3986,chair,phone,crossclassified,7,7,0
8269,hotdog,wrapper,crossclassified,7,7,0
5419,chest,dresser,synonymy,7,0,7
5147,dress,ring,crossclassified,7,7,0
5241,apples,bowl,crossclassified,7,0,7
6040,boy,shirts,crossclassified,7,7,0
10882,bathtub,shoes,crossclassified,7,7,0
9020,building,stairs,crossclassified,7,7,0
8286,child,toy,crossclassified,7,7,0
2325,coat,girl,crossclassified,7,0,7
11607,luggage,suitcase,hypernymy.1,7,0,7
6002,lady,shirt,crossclassified,7,0,7
5416,doorway,house,crossclassified,7,1,6
2328,bed,clothes,crossclassified,7,7,0
1240,arch,bench,crossclassified,7,0,7
5731,dress,rug,crossclassified,7,0,7
8545,t-shirt,van,crossclassified,7,0,7
5199,squash,vegetable,hypernymy.2,7,7,0
6141,cat,reflection,crossclassified,7,7,0
2739,boat,man,crossclassified,7,3,4
2737,belt,boat,crossclassified,7,0,7
5475,antique,vase,crossclassified,7,0,7
8200,bulldog,dog,hypernymy.2,7,0,7
8778,boat,cat,crossclassified,7,7,0
5649,giraffe,shirt,crossclassified,7,3,4
1127,dugout,jersey,crossclassified,7,7,0
3895,cart,trailer,co-hyponymy,7,7,0
9093,cabinet,toothbrush,crossclassified,7,0,7
5161,building,woman,crossclassified,7,2,5
8582,boy,head,crossclassified,7,2,5
3603,arm,curtain,crossclassified,7,0,7
10792,grass,shoe,crossclassified,7,7,0
8577,cap,tent,crossclassified,7,0,7
2395,pole,sheep,crossclassified,7,0,7
4008,batter,helmet,crossclassified,7,7,0
5187,cup,latte,crossclassified,7,7,0
6154,cake,truck,crossclassified,7,7,0
5712,board,surfer,crossclassified,7,0,7
14103,rail,snowboard,crossclassified,7,7,0
3844,shirt,sink,crossclassified,7,5,2
8565,kitchen,table,crossclassified,7,3,4
6146,building,helmet,crossclassified,7,7,0
80,dugout,field,crossclassified,7,7,0
10909,curtain,sing,crossclassified,7,7,0
1844,collar,jacket,crossclassified,7,1,6
1791,child,sweater,co-hyponymy,7,6,1
439,juice,table,crossclassified,7,0,7
8425,apple,boy,crossclassified,7,0,7
8516,placeman,rug,crossclassified,7,0,7
5375,bun,counter,crossclassified,7,0,7
1790,cardigan,sweater,hypernymy.2,7,0,7
1287,dugout,hat,crossclassified,7,7,0
1864,bridge,house,crossclassified,7,6,1
1284,doge,sheep,crossclassified,7,0,7
382,girl,grill,crossclassified,7,6,1
5849,giraffe,wall,crossclassified,7,7,0
5848,chain,dog,crossclassified,7,0,7
5847,shirt,snack,crossclassified,7,7,0
3690,hotdog,roll,crossclassified,7,7,0
2586,plane,vehicles,hypernymy.2,7,7,0
3910,clothing,vest,hypernymy.1,7,0,7
5823,carpet,plate,crossclassified,7,7,0
8462,giraffe,horse,crossclassified,7,3,4
3698,floor,tile,crossclassified,7,7,0
5818,cabana,tent,hypernymy.2,7,0,7
5815,jacket,tent,crossclassified,7,0,7
3896,cart,container,hypernymy.2,7,7,0
5799,cup,pot,co-hyponymy,7,4,3
2362,shirt,shoe,crossclassified,7,3,4
14222,man,show,crossclassified,7,7,0
5891,mantel,mantle,synonymy,7,0,7
13048,bird,roof,crossclassified,7,0,7
11089,bug,keyboard,crossclassified,7,7,0
8537,car,coat,crossclassified,7,7,0
8341,plane,truck,crossclassified,7,7,0
10932,counter,pineapple,crossclassified,7,7,0
2645,skateboard,snowboarder,crossclassified,7,0,7
14973,airport,floor,crossclassified,7,0,7
5986,person,teen,hypernymy.1,7,7,0
5973,talker,woman,crossclassified,7,0,7
5960,class,table,co-hyponymy,7,0,7
8525,cupboard,dresser,crossclassified,7,0,7
8523,dresser,wooden,crossclassified,7,7,0
2551,shoe,tent,crossclassified,7,0,7
1247,counter,toothbrush,crossclassified,7,7,0
14192,cake,clock,crossclassified,7,0,7
3666,clothing,couch,crossclassified,7,0,7
11550,mobile,person,crossclassified,7,0,7
8379,lettuce,plate,crossclassified,7,7,0
2611,waitress,woman,crossclassified,7,0,7
5917,carriage,wagon,co-hyponymy,7,7,0
1796,paper,pizza,crossclassified,7,0,7
1296,egg,pan,crossclassified,7,0,7
2605,bent,food,crossclassified,7,0,7
3681,soup,vegetables,crossclassified,7,7,0
5319,drinks,woman,crossclassified,7,0,7
11423,counter,jacket,crossclassified,7,7,0
11054,keyboard,laptop,crossclassified,7,5,2
2496,passenger,woman,crossclassified,7,0,7
13190,cat,sweater,crossclassified,7,7,0
11754,armoire,wardrobe,hypernymy.2,7,0,7
944,giraffe,prow,crossclassified,7,7,0
5038,girl,toothbrush,crossclassified,7,7,0
10640,cabinets,oven,crossclassified,7,7,0
334,candle,counter,crossclassified,7,0,7
13957,bear,curtain,crossclassified,7,0,7
3765,skateboarder,women,crossclassified,7,7,0
5041,dress,surfer,crossclassified,7,0,7
12897,pancake,toast,crossclassified,7,7,0
9220,building,outhouse,hypernymy.1,7,1,6
11790,building,westminster,crossclassified,7,7,0
6373,jacket,shoulders,crossclassified,7,7,0
420,counter,dresser,co-hyponymy,7,5,2
8071,cabbage,vegetable,hypernymy.2,7,7,0
4996,pitcher,t-shirt,crossclassified,7,7,0
4150,blanket,shirt,crossclassified,7,3,4
9216,house,outhouse,crossclassified,7,0,7
8766,car,pole,crossclassified,7,7,0
6357,awning,roof,crossclassified,7,4,3
6355,roof,shelter,co-hyponymy,7,7,0
3520,cake,snacks,crossclassified,7,7,0
1688,man,officer,hypernymy.1,7,7,0
8707,pant,surfer,crossclassified,7,0,7
8036,fruit,woman,crossclassified,7,0,7
1940,goldman,man,crossclassified,7,0,7
520,button,jacket,crossclassified,7,0,7
25,curtain,desk,crossclassified,7,4,3
2847,bikes,motorcycle,synonymy,7,0,7
5581,airplane,fan,crossclassified,7,7,0
8028,cabinets,chair,crossclassified,7,7,0
11782,floor,patio,crossclassified,7,0,7
1196,dish,fruit,crossclassified,7,0,7
6460,mirror,sink,crossclassified,7,0,7
11760,pant,rug,crossclassified,7,0,7
521,gloves,jacket,crossclassified,7,0,7
927,racket,shirt,crossclassified,7,0,7
11290,shoe,truck,crossclassified,7,0,7
4131,bird,wing,crossclassified,7,7,0
11289,curtain,phone,crossclassified,7,7,0
5031,clothing,tie,hypernymy.1,7,0,7
34,child,glass,crossclassified,7,7,0
6475,counter,woman,crossclassified,7,3,4
926,athlete,shirt,crossclassified,7,2,5
5002,horse,sheep,crossclassified,7,3,4
8724,banana,phone,crossclassified,7,0,7
2468,costume,shirt,crossclassified,7,0,7
4155,airplane,model,crossclassified,7,7,0
5491,bag,rug,crossclassified,7,0,7
3821,child,head,crossclassified,7,2,5
3557,floor,jacket,crossclassified,7,6,1
5116,hand,hotdog,crossclassified,7,3,4
2416,bird,parakeet,hypernymy.1,7,7,0
2414,jacket,windbreaker,hypernymy.1,7,7,0
963,mirror,woman,crossclassified,7,0,7
9178,food,ham,hypernymy.1,7,7,0
8144,bicycle,car,co-hyponymy,7,0,7
12880,pants,wheelchair,crossclassified,7,0,7
1730,streetcar,train,crossclassified,7,0,7
2413,blender,bottle,crossclassified,7,7,0
8692,car,police,crossclassified,7,7,0
4051,bobcat,cat,hypernymy.2,7,0,7
2752,pan,pasta,crossclassified,7,7,0
5132,curtain,lamp,crossclassified,7,1,6
5486,bike,building,crossclassified,7,0,7
8177,appliance,blender,crossclassified,7,0,7
4974,bun,roll,synonymy,7,7,0
3822,car,carpet,crossclassified,7,7,0
2205,tanker,train,crossclassified,7,0,7
5009,console,table,hypernymy.2,7,0,7
56,blind,curtain,hypernymy.1,7,0,7
6296,blender,dixie,crossclassified,7,7,0
2473,guy,skater,crossclassified,7,0,7
2253,kid,shirt,crossclassified,7,0,7
8073,bag,girl,crossclassified,7,0,7
4980,fish,meat,co-hyponymy,7,4,3
3545,pizza,quiche,crossclassified,7,7,0
2470,car,hatchback,hypernymy.1,7,7,0
1143,car,tractor,crossclassified,7,5,2
3817,cabinet,man,crossclassified,7,4,3
9212,bed,flowerpot,crossclassified,7,7,0
496,carrot,vegetable,hypernymy.2,7,4,3
6285,skate,surfer,crossclassified,7,0,7
9213,bench,luggage,crossclassified,7,7,0
1920,motorcycle,woman,crossclassified,7,3,4
1167,desert,food,crossclassified,7,0,7
11406,desk,mirror,crossclassified,7,7,0
6283,sink,tile,crossclassified,7,7,0
1366,arugula,salad,crossclassified,7,0,7
8498,slope,snow,crossclassified,6,0,6
3298,man,server,crossclassified,6,6,0
7311,awning,canopy,hypernymy.2,6,3,3
1837,cowgirl,woman,crossclassified,6,0,6
8657,jeans,skateboarder,crossclassified,6,0,6
8639,pole,table,crossclassified,6,0,6
3772,sandwich,sauce,crossclassified,6,1,5
8507,truck,vehicles,hypernymy.2,6,6,0
7364,jacket,pole,crossclassified,6,6,0
7495,house,table,crossclassified,6,6,0
4441,oven,pizza,crossclassified,6,6,0
7427,fence,truck,crossclassified,6,0,6
8780,cow,man,crossclassified,6,2,4
8588,bikes,motorcycles,synonymy,6,0,6
8578,tent,tents,synonymy,6,6,0
8574,ball,jacket,crossclassified,6,0,6
3841,bride,dress,crossclassified,6,2,4
1529,chair,house,crossclassified,6,1,5
3756,couch,seating,crossclassified,6,6,0
1820,bun,hamburger,crossclassified,6,1,5
7442,bowl,carrot,crossclassified,6,6,0
3254,athlete,snowboarder,crossclassified,6,0,6
3253,snowboard,snowboarder,crossclassified,6,0,6
13525,bathtub,brush,crossclassified,6,6,0
4502,goat,lamb,co-hyponymy,6,6,0
3249,catcher,glove,crossclassified,6,6,0
12300,desk,mobile,crossclassified,6,6,0
3860,cub,table,crossclassified,6,0,6
3278,pan,turkey,crossclassified,6,6,0
434,dress,hair,crossclassified,6,5,1
9712,awning,station,crossclassified,6,6,0
8848,bridge,deck,hypernymy.2,6,6,0
7478,tree,woman,crossclassified,6,0,6
8633,bed,women,crossclassified,6,6,0
3866,baby,dress,crossclassified,6,3,3
659,monorail,train,crossclassified,6,0,6
3287,hat,head,crossclassified,6,6,0
8725,phone,telephone,synonymy,6,6,0
4514,hut,tent,co-hyponymy,6,5,1
7488,dog,wheel,crossclassified,6,6,0
8591,cup,holder,crossclassified,6,6,0
4165,man,spoon,crossclassified,6,6,0
3300,man,strap,crossclassified,6,6,0
9214,bench,suitcase,crossclassified,6,6,0
1613,boy,remote,crossclassified,6,6,0
3421,bun,cake,crossclassified,6,2,4
3541,chair,toddler,crossclassified,6,6,0
4110,plant,roots,crossclassified,6,6,0
9444,door,trunk,crossclassified,6,5,1
9445,door,hatch,co-hyponymy,6,6,0
3414,building,chair,crossclassified,6,4,2
12421,toy,train,crossclassified,6,0,6
1704,bridge,shirt,crossclassified,6,6,0
4264,lion,lioness,hypernymy.1,6,6,0
3549,arm,man,crossclassified,6,1,5
4094,cake,wrapper,crossclassified,6,0,6
7820,airplane,hangar,crossclassified,6,6,0
3554,boat,bow,crossclassified,6,6,0
8107,basket,food,crossclassified,6,0,6
3561,burger,grill,crossclassified,6,0,6
12607,arm,couch,crossclassified,6,0,6
13134,man,santa,crossclassified,6,6,0
4043,train,windshield,crossclassified,6,6,0
8189,apartments,building,crossclassified,6,0,6
13125,vest,woman,crossclassified,6,0,6
9111,cat,suitcase,crossclassified,6,6,0
3590,cat,doll,crossclassified,6,6,0
580,desk,shelving,crossclassified,6,6,0
1921,car,chair,crossclassified,6,5,1
12740,juicer,orange,crossclassified,6,6,0
1984,salad,spoon,crossclassified,6,2,4
15762,bush,wall,crossclassified,6,0,6
1674,guy,surfer,crossclassified,6,0,6
1662,archway,bridge,crossclassified,6,0,6
9308,elephant,man,crossclassified,6,0,6
7940,dog,tent,crossclassified,6,0,6
9265,bird,boat,crossclassified,6,2,4
1960,eyeglasses,woman,crossclassified,6,0,6
1967,counter,stand,co-hyponymy,6,6,0
8010,counter,vessels,crossclassified,6,6,0
8011,cheese,shirt,crossclassified,6,0,6
12535,counter,workbench,crossclassified,6,6,0
14874,clock,ottoman,crossclassified,6,6,0
4209,hand,person,hypernymy.2,6,1,5
8029,cabinets,cupboard,crossclassified,6,6,0
15760,toilet,wall,crossclassified,6,0,6
4132,bird,feather,crossclassified,6,6,0
12245,floor,television,crossclassified,6,6,0
9380,splash,water,crossclassified,6,0,6
1935,pole,zebra,crossclassified,6,0,6
8056,awning,building,crossclassified,6,0,6
9233,bottle,shampoo,crossclassified,6,6,0
9230,car,scooter,co-hyponymy,6,2,4
4240,sweatshirt,t-shirt,crossclassified,6,6,0
8205,bird,brits,crossclassified,6,6,0
4275,blanket,carpet,crossclassified,6,1,5
3598,dress,lady,crossclassified,6,6,0
7813,suit,woman,crossclassified,6,0,6
3340,bangle,woman,crossclassified,6,0,6
7622,bench,window,crossclassified,6,6,0
13042,boat,canopy,crossclassified,6,6,0
3660,human,shirt,crossclassified,6,0,6
4372,baker,man,co-hyponymy,6,0,6
3662,sheep,t-shirt,crossclassified,6,6,0
1766,counter,washroom,crossclassified,6,6,0
3664,baby,couch,crossclassified,6,0,6
9631,chair,electronics,crossclassified,6,6,0
3665,couch,kid,crossclassified,6,6,0
8977,cake,cupcakes,hypernymy.1,6,0,6
12332,grass,pasture,synonymy,6,6,0
8408,balloon,woman,crossclassified,6,0,6
8963,mobile,phone,crossclassified,6,0,6
3922,cloak,robe,crossclassified,6,0,6
4401,fruit,produce,crossclassified,6,6,0
2037,airplane,warplane,co-hyponymy,6,6,0
8444,building,hydrant,crossclassified,6,6,0
9657,shelf,sink,crossclassified,6,0,6
3316,got,sheep,crossclassified,6,0,6
4408,bowl,snacks,crossclassified,6,6,0
3693,salad,veg,crossclassified,6,6,0
1786,boys,couch,crossclassified,6,0,6
7624,ballerina,woman,crossclassified,6,0,6
3654,jacket,snow,crossclassified,6,6,0
8994,bed,mouse,crossclassified,6,6,0
3617,bird,cat,crossclassified,6,2,4
585,bookshelf,desk,crossclassified,6,2,4
3391,bed,cake,crossclassified,6,3,3
9087,apron,jacket,crossclassified,6,0,6
1741,boy,watch,crossclassified,6,6,0
8228,taco,tortilla,crossclassified,6,6,0
4011,bowl,platter,crossclassified,6,6,0
4289,coat,floor,crossclassified,6,0,6
340,cup,girl,crossclassified,6,0,6
8239,fruit,man,crossclassified,6,0,6
12381,chair,fork,crossclassified,6,6,0
8240,book,dog,crossclassified,6,0,6
8336,controller,curtain,crossclassified,6,0,6
4003,boy,toothbrush,crossclassified,6,6,0
1743,boy,sofa,crossclassified,6,5,1
7754,blanket,cover,synonymy,6,6,0
9040,tie,ties,synonymy,6,6,0
8277,carpet,wooden,crossclassified,6,6,0
13349,girl,sheep,crossclassified,6,6,0
3642,bottle,jacket,crossclassified,6,0,6
7685,skate,woman,crossclassified,6,0,6
3645,computer,curtain,crossclassified,6,0,6
1949,boat,vessel,hypernymy.2,6,6,0
365,camel,zebra,crossclassified,6,0,6
13088,dogs,surfboard,crossclassified,6,0,6
10332,ball,player,crossclassified,6,0,6
2252,hat,headgear,hypernymy.2,6,6,0
6157,controller,table,crossclassified,6,0,6
6786,bike,sidecar,crossclassified,6,0,6
4828,diner,man,crossclassified,6,0,6
4829,decals,motorcycle,crossclassified,6,0,6
6751,bowl,stew,crossclassified,6,6,0
15615,bear,person,hypernymy.2,6,6,0
2232,boy,curtain,crossclassified,6,0,6
6723,medic,woman,crossclassified,6,0,6
11926,bowl,lobster,crossclassified,6,6,0
6715,motorcycle,police,crossclassified,6,6,0
2969,cargo,train,crossclassified,6,0,6
2818,bowl,chili,crossclassified,6,6,0
2150,adult,man,hypernymy.1,6,0,6
6710,clutter,desk,crossclassified,6,0,6
14205,carpet,cats,crossclassified,6,6,0
5033,cake,frosting,crossclassified,6,6,0
5922,basket,sandwich,crossclassified,6,0,6
10368,horse,tree,crossclassified,6,6,0
15264,fence,rail,co-hyponymy,6,6,0
2160,skateboarder,wheel,crossclassified,6,6,0
11895,desk,electronic,crossclassified,6,6,0
5936,plane,runway,crossclassified,6,6,0
2162,cupcake,icing,crossclassified,6,6,0
5943,box,desk,crossclassified,6,0,6
6148,child,class,crossclassified,6,6,0
1412,blanket,woman,crossclassified,6,0,6
10385,girl,sister,hypernymy.1,6,6,0
13870,glass,tea,crossclassified,6,0,6
2622,van,woman,crossclassified,6,4,2
5315,bowl,chinese,crossclassified,6,6,0
11955,rug,tile,crossclassified,6,6,0
5185,dish,pizza,hypernymy.1,6,0,6
6881,bottle,child,crossclassified,6,0,6
3048,board,boat,crossclassified,6,0,6
12043,bed,donut,crossclassified,6,6,0
11056,keyboard,lap,crossclassified,6,6,0
6503,fruit,shirt,crossclassified,6,0,6
14252,frame,picture,hypernymy.2,6,0,6
14031,beak,penguin,crossclassified,6,0,6
11053,motorcycle,policeman,crossclassified,6,6,0
6906,lion,tiger,co-hyponymy,6,6,0
2250,boy,bread,crossclassified,6,6,0
4772,animal,house,crossclassified,6,0,6
6896,shorts,skateboarder,crossclassified,6,0,6
11046,dresser,rack,crossclassified,6,6,0
11735,towel,woman,crossclassified,6,0,6
5820,surfboard,table,crossclassified,6,0,6
15320,cellphone,hand,crossclassified,6,0,6
6878,condiment,sauce,hypernymy.1,6,0,6
3021,blanket,table,crossclassified,6,0,6
5082,drinks,shirt,crossclassified,6,0,6
3019,jacket,shoe,crossclassified,6,6,0
954,marina,port,crossclassified,6,6,0
15219,building,tables,co-hyponymy,6,6,0
3015,car,hydrant,crossclassified,6,6,0
1058,bird,toy,crossclassified,6,5,1
6359,elephant,roof,crossclassified,6,4,2
2721,man,walker,crossclassified,6,6,0
2235,curtain,dress,crossclassified,6,6,0
11965,carpet,phone,crossclassified,6,6,0
6175,house,siding,crossclassified,6,6,0
2623,shirt,van,crossclassified,6,0,6
10612,bird,puffin,hypernymy.1,6,6,0
4886,beard,man,co-hyponymy,6,2,4
11625,glass,house,crossclassified,6,0,6
2185,eater,man,crossclassified,6,0,6
5260,sink,wash,crossclassified,6,6,0
2214,giraffe,net,crossclassified,6,6,0
6538,child,coat,crossclassified,6,6,0
2666,shirt,sleeve,crossclassified,6,6,0
2891,man,wall,crossclassified,6,5,1
10573,food,melon,hypernymy.1,6,0,6
5008,shelves,table,crossclassified,6,0,6
994,dress,tops,co-hyponymy,6,6,0
6045,gate,giraffe,crossclassified,6,0,6
5233,bagel,cake,crossclassified,6,5,1
989,beverage,bottle,crossclassified,6,0,6
2889,bridge,structure,hypernymy.2,6,6,0
908,cap,hydrant,crossclassified,6,0,6
6563,grate,grates,synonymy,6,6,0
11626,carpet,stool,crossclassified,6,6,0
13935,cinderella,princess,crossclassified,6,6,0
2192,bed,phone,crossclassified,6,6,0
2855,eyeglass,shirt,crossclassified,6,0,6
2861,ottoman,sofa,co-hyponymy,6,6,0
2311,airport,runway,crossclassified,6,1,5
14577,complainer,plane,crossclassified,6,0,6
10539,pig,toy,crossclassified,6,6,0
2195,microphone,woman,crossclassified,6,0,6
6517,sign,signboard,synonymy,6,6,0
6094,motorcycle,vesicular,crossclassified,6,6,0
4976,orange,woman,crossclassified,6,0,6
10542,kite,pig,crossclassified,6,0,6
2850,shirt,tank,crossclassified,6,6,0
732,server,woman,crossclassified,6,0,6
1409,bag,skier,crossclassified,6,0,6
2696,hand,man,crossclassified,6,1,5
4889,hair,man,crossclassified,6,0,6
5028,fabric,tie,crossclassified,6,0,6
14188,legs,skateboarder,crossclassified,6,1,5
2938,bowl,cub,crossclassified,6,6,0
2832,curtain,mirror,crossclassified,6,6,0
2338,dugout,person,crossclassified,6,6,0
14457,man,tress,crossclassified,6,6,0
10831,jeans,legs,crossclassified,6,0,6
4899,animal,buffalo,hypernymy.1,6,6,0
2637,mantle,table,crossclassified,6,3,3
5278,uniform,woman,crossclassified,6,0,6
13964,beanbag,blanket,crossclassified,6,0,6
172,carpeting,floor,crossclassified,6,0,6
2921,man,skate,crossclassified,6,6,0
2184,bottle,cat,crossclassified,6,1,5
930,cake,dog,crossclassified,6,1,5
897,headband,woman,crossclassified,6,0,6
6118,performer,woman,crossclassified,6,0,6
5269,donut,eclair,crossclassified,6,6,0
1388,bun,jacket,crossclassified,6,0,6
10466,blanket,rug,crossclassified,6,4,2
13900,docks,marina,hypernymy.1,6,0,6
1015,jumper,shirt,co-hyponymy,6,0,6
5997,bun,woman,crossclassified,6,0,6
5010,animal,table,crossclassified,6,0,6
6589,bridge,trellis,crossclassified,6,6,0
6114,glove,mitten,hypernymy.1,6,0,6
2650,dress,women,crossclassified,6,6,0
3049,boat,river,crossclassified,6,6,0
4767,asian,woman,crossclassified,6,0,6
5366,girl,uniform,crossclassified,6,6,0
5605,bench,platform,crossclassified,6,6,0
2419,pottery,wall,crossclassified,6,6,0
7162,motorcycle,rug,crossclassified,6,4,2
5611,blender,food,crossclassified,6,6,0
14051,cup,sauce,crossclassified,6,0,6
7160,blanket,cat,crossclassified,6,3,3
4628,wall,woman,crossclassified,6,0,6
5637,animal,car,crossclassified,6,0,6
13638,plate,tortilla,crossclassified,6,0,6
13640,food,tortilla,hypernymy.1,6,2,4
7122,belt,shirt,crossclassified,6,0,6
5485,building,doorway,crossclassified,6,6,0
2409,eyeglasses,man,crossclassified,6,0,6
2265,catcher,gloves,crossclassified,6,6,0
3144,chairs,couch,co-hyponymy,6,0,6
12159,table,windowsill,crossclassified,6,6,0
799,glass,liquid,crossclassified,6,6,0
3139,container,water,crossclassified,6,6,0
7074,flower,pot,crossclassified,6,6,0
3134,basket,dress,crossclassified,6,0,6
212,lateen,toilet,crossclassified,6,0,6
7070,chair,mat,crossclassified,6,6,0
3131,shorts,skater,crossclassified,6,0,6
5802,airplane,shirt,crossclassified,6,6,0
5680,bible,book,synonymy,6,0,6
5689,bridge,signal,crossclassified,6,6,0
5447,bench,glass,crossclassified,6,6,0
10012,trunk,van,crossclassified,6,6,0
46,cat,cow,crossclassified,6,6,0
5595,grate,grill,co-hyponymy,6,0,6
7059,curtain,head,crossclassified,6,6,0
3187,court,ground,crossclassified,6,6,0
2431,dog,figurine,crossclassified,6,6,0
4544,boat,pool,crossclassified,6,6,0
4545,counter,dress,crossclassified,6,5,1
2427,bread,fruit,crossclassified,6,6,0
6229,leg,shoe,crossclassified,6,6,0
2073,skier,snow,crossclassified,6,4,2
2443,bread,woman,crossclassified,6,0,6
5567,counter,snacks,crossclassified,6,6,0
5572,knife,utensil,crossclassified,6,6,0
7260,bowl,chair,crossclassified,6,1,5
5146,banana,dress,crossclassified,6,0,6
14067,statue,stump,crossclassified,6,0,6
2455,fence,tarp,crossclassified,6,6,0
4573,pen,stable,crossclassified,6,6,0
4577,fence,pen,crossclassified,6,0,6
13601,wall,window,crossclassified,6,0,6
4591,meat,salmon,crossclassified,6,0,6
7211,scissors,woman,crossclassified,6,0,6
11286,curtain,mobile,crossclassified,6,6,0
12204,handlebar,motorcycle,crossclassified,6,0,6
10710,see,woman,crossclassified,6,0,6
12200,bicycle,desk,crossclassified,6,0,6
11373,cabinet,glass,crossclassified,6,6,0
7197,bread,chicken,crossclassified,6,6,0
1329,food,ketchup,hypernymy.1,6,6,0
7182,glass,sink,crossclassified,6,0,6
2466,body,shirt,crossclassified,6,0,6
61,man,toy,crossclassified,6,6,0
4675,clock,desk,crossclassified,6,0,6
2765,cupcake,table,crossclassified,6,1,5
4741,shirt,women,crossclassified,6,6,0
1099,ladle,spoon,crossclassified,6,0,6
6978,graffiti,train,crossclassified,6,0,6
2767,bathroom,curtain,crossclassified,6,0,6
3081,closet,dresser,co-hyponymy,6,0,6
6281,engine,plane,crossclassified,6,0,6
11102,bricks,bridge,crossclassified,6,0,6
2374,fork,salad,crossclassified,6,4,2
1070,bench,seats,hypernymy.2,6,6,0
207,clothing,girl,crossclassified,6,0,6
5776,bear,rice,crossclassified,6,0,6
6970,cap,person,crossclassified,6,0,6
11091,bug,cricket,crossclassified,6,6,0
10690,car,pant,crossclassified,6,6,0
13719,pasta,sauce,crossclassified,6,0,6
814,horse,jockey,crossclassified,6,6,0
5384,camera,person,crossclassified,6,0,6
6953,couch,jersey,crossclassified,6,6,0
2779,jacket,pullover,crossclassified,6,6,0
10137,bathroom,counter,crossclassified,6,0,6
5376,horse,jumper,crossclassified,6,6,0
2781,boat,trailer,crossclassified,6,6,0
2123,player,umpire,crossclassified,6,0,6
6930,blender,smoothie,crossclassified,6,6,0
4757,furniture,shelf,crossclassified,6,0,6
6191,computer,man,crossclassified,6,0,6
6303,bed,paper,crossclassified,6,6,0
5798,container,pot,hypernymy.1,6,0,6
10681,chicken,hen,hypernymy.1,6,6,0
208,girl,sweater,crossclassified,6,5,1
1080,bed,camera,crossclassified,6,6,0
4984,tourist,woman,crossclassified,6,0,6
5441,jacket,sleeve,crossclassified,6,6,0
5420,airplane,seaplane,hypernymy.1,6,6,0
5714,shoe,surfer,crossclassified,6,0,6
10035,airplane,water,crossclassified,6,6,0
12867,book,shirt,crossclassified,6,0,6
2102,grill,table,crossclassified,6,6,0
3096,awning,umbrella,co-hyponymy,6,0,6
3099,couch,electronics,crossclassified,6,6,0
5425,child,mobile,crossclassified,6,6,0
2108,broccoli,table,crossclassified,6,0,6
1241,archway,bench,crossclassified,6,0,6
6209,bed,jacket,crossclassified,6,5,1
6279,dancer,girl,crossclassified,6,0,6
5745,rug,wheel,crossclassified,6,6,0
8217,cot,table,crossclassified,5,0,5
5150,dog,hound,synonymy,5,5,0
6208,bowl,greens,crossclassified,5,5,0
8222,lion,zebra,crossclassified,5,4,1
3994,airplane,truck,crossclassified,5,2,3
481,animal,ram,crossclassified,5,4,1
8181,girl,pillow,crossclassified,5,5,0
6221,man,policeman,crossclassified,5,5,0
8216,building,motorcycle,crossclassified,5,5,0
4019,egg,yolk,crossclassified,5,5,0
13128,scarf,tie,crossclassified,5,0,5
5154,bookshelf,library,crossclassified,5,5,0
4005,batter,hitter,synonymy,5,5,0
4037,audience,dugout,crossclassified,5,0,5
6162,girl,kite,crossclassified,5,5,0
4009,bench,carpet,crossclassified,5,1,4
4001,bike,jacket,crossclassified,5,0,5
6195,books,shelf,crossclassified,5,0,5
14102,cow,tent,crossclassified,5,0,5
1322,headlight,truck,crossclassified,5,0,5
5193,bird,cockatoo,hypernymy.1,5,5,0
14080,frisbee,plate,hypernymy.2,5,5,0
6124,jacket,truck,crossclassified,5,0,5
1330,food,potato,hypernymy.1,5,5,0
1736,shirt,sleeveless,crossclassified,5,5,0
5163,foal,zebra,crossclassified,5,0,5
1740,boy,son,synonymy,5,5,0
4023,table,television,crossclassified,5,5,0
4031,belt,boy,crossclassified,5,0,5
4027,boy,playing,crossclassified,5,5,0
4539,bridge,ramp,crossclassified,5,5,0
982,meal,soup,crossclassified,5,0,5
3871,desk,toy,crossclassified,5,5,0
5704,building,glass,crossclassified,5,5,0
1232,car,wagon,hypernymy.1,5,5,0
14276,shoe,sidewalk,crossclassified,5,0,5
3858,tailor,truck,crossclassified,5,0,5
5744,doll,man,crossclassified,5,0,5
12944,food,rhubarb,hypernymy.1,5,0,5
1100,carrot,spoon,crossclassified,5,0,5
5770,car,luggage,crossclassified,5,5,0
1067,airplane,pant,crossclassified,5,5,0
6080,shirt,snacks,crossclassified,5,5,0
8514,blanket,quilt,co-hyponymy,5,5,0
8512,airplane,window,crossclassified,5,5,0
5372,gentleman,man,synonymy,5,0,5
8508,pan,woman,crossclassified,5,0,5
8499,hill,snow,crossclassified,5,0,5
5370,bucket,pot,co-hyponymy,5,0,5
8478,man,scissor,crossclassified,5,5,0
5809,pavilion,tent,hypernymy.2,5,0,5
5699,bed,legs,crossclassified,5,5,0
8569,bed,skirt,crossclassified,5,5,0
5458,food,lasagna,hypernymy.1,5,5,0
14381,bricks,wall,crossclassified,5,5,0
1176,cupcake,donut,crossclassified,5,1,4
5554,dog,dress,crossclassified,5,5,0
8647,class,mirror,crossclassified,5,0,5
5561,girl,helmet,crossclassified,5,5,0
3798,bottle,juice,crossclassified,5,5,0
5578,boy,donut,crossclassified,5,5,0
5521,singer,woman,crossclassified,5,0,5
5520,lettuce,vegetables,hypernymy.2,5,4,1
5518,helmet,jacket,crossclassified,5,0,5
8632,coat,cow,crossclassified,5,0,5
14358,baby,toy,crossclassified,5,5,0
1140,forklift,tractor,co-hyponymy,5,0,5
5632,giraffe,grill,crossclassified,5,5,0
14372,apple,carpet,crossclassified,5,0,5
5648,wood,zebra,crossclassified,5,0,5
5471,keyboard,shelf,crossclassified,5,1,4
14308,orange,toaster,crossclassified,5,0,5
8465,boy,polo,crossclassified,5,5,0
12983,boy,keyboard,crossclassified,5,5,0
5353,desk,vehicle,crossclassified,5,5,0
5293,bowl,skillet,crossclassified,5,5,0
14187,food,strawberry,hypernymy.1,5,1,4
8369,cat,tie,crossclassified,5,5,0
13038,floor,skateboards,crossclassified,5,5,0
5983,foot,woman,crossclassified,5,0,5
5985,knife,man,crossclassified,5,0,5
5273,person,pizza,crossclassified,5,4,1
5991,helmet,house,crossclassified,5,0,5
13044,boat,tarp,crossclassified,5,5,0
3965,bottle,champagne,crossclassified,5,5,0
3970,bat,house,crossclassified,5,0,5
14170,broccoli,girl,crossclassified,5,0,5
8303,guy,skier,crossclassified,5,0,5
5258,house,motorcycle,crossclassified,5,5,0
6020,kitchen,man,crossclassified,5,0,5
6029,meat,turkey,hypernymy.1,5,0,5
6070,fridge,man,crossclassified,5,0,5
5226,house,station,crossclassified,5,5,0
5946,garage,truck,crossclassified,5,5,0
5294,bowl,casserole,co-hyponymy,5,5,0
8453,girl,gown,crossclassified,5,5,0
5944,desk,tile,crossclassified,5,5,0
5350,jacket,jumper,hypernymy.1,5,5,0
12987,house,skateboard,crossclassified,5,5,0
5828,boat,boy,crossclassified,5,5,0
5857,cow,milk,crossclassified,5,5,0
1285,dugout,tent,co-hyponymy,5,5,0
5864,animal,train,crossclassified,5,0,5
3916,cowboy,man,crossclassified,5,0,5
5328,airplane,fighter,hypernymy.1,5,5,0
5894,mantle,shelf,hypernymy.2,5,5,0
5317,track,truck,crossclassified,5,0,5
8410,animal,curtain,crossclassified,5,0,5
5907,snacks,woman,crossclassified,5,0,5
8404,shoe,t-shirt,crossclassified,5,5,0
6244,bread,sauce,crossclassified,5,1,4
8385,woman,wooden,crossclassified,5,5,0
1033,goggles,skier,crossclassified,5,0,5
1300,pizza,veg,crossclassified,5,5,0
6242,bird,woman,hypernymy.2,5,0,5
8025,jacket,jersey,crossclassified,5,4,1
1333,coco,cow,crossclassified,5,0,5
7618,bird,sea,crossclassified,5,5,0
7646,plane,pole,crossclassified,5,5,0
1575,beer,wine,crossclassified,5,5,0
4355,condiment,hotdog,crossclassified,5,0,5
6950,train,windows,crossclassified,5,5,0
4366,carpet,wheel,crossclassified,5,5,0
14800,awning,board,crossclassified,5,5,0
4748,caller,woman,crossclassified,5,0,5
6955,boy,net,crossclassified,5,5,0
4738,jersey,woman,crossclassified,5,0,5
13717,goat,suit,crossclassified,5,0,5
4729,sidewalk,street,crossclassified,5,4,1
588,building,post,crossclassified,5,5,0
6972,ballplayer,man,crossclassified,5,0,5
7612,shorts,table,crossclassified,5,0,5
7589,skiers,snow,crossclassified,5,0,5
4392,lamp,pole,crossclassified,5,4,1
6992,sauce,syrup,crossclassified,5,5,0
4402,apples,fruit,hypernymy.2,5,0,5
7010,alpaca,sheep,crossclassified,5,0,5
7017,board,dugout,crossclassified,5,0,5
7554,bench,rug,crossclassified,5,1,4
4702,cat,hamster,crossclassified,5,0,5
4351,banana,plate,crossclassified,5,4,1
7654,clock,statue,crossclassified,5,0,5
4760,pole,post,crossclassified,5,5,0
7671,cake,cheese,crossclassified,5,5,0
1430,giraffe,stone,crossclassified,5,5,0
7790,desk,newspaper,crossclassified,5,5,0
4818,goalie,woman,crossclassified,5,5,0
4815,fruit,knife,crossclassified,5,0,5
1604,boat,flag,crossclassified,5,5,0
4812,booth,pizza,crossclassified,5,5,0
6818,girl,glass,crossclassified,5,5,0
4803,hood,truck,crossclassified,5,4,1
1434,taxi,wheel,crossclassified,5,5,0
7772,athlete,shoe,crossclassified,5,0,5
4799,coat,sheep,crossclassified,5,0,5
601,skater,teenager,crossclassified,5,5,0
6880,dress,dugout,crossclassified,5,0,5
4785,bat,catcher,crossclassified,5,0,5
6890,giraffe,girl,crossclassified,5,2,3
7751,stand,tent,crossclassified,5,0,5
7738,rope,shirt,crossclassified,5,0,5
7717,bike,road,crossclassified,5,0,5
4333,birdbath,planter,crossclassified,5,0,5
13742,airplane,light,crossclassified,5,5,0
4764,couch,mat,crossclassified,5,5,0
7020,truck,trucked,crossclassified,5,5,0
7025,building,porch,co-hyponymy,5,5,0
4410,cat,clock,crossclassified,5,4,1
7403,carpet,jacket,crossclassified,5,5,0
7171,ball,dolphin,crossclassified,5,0,5
7175,man,sandwich,crossclassified,5,4,1
4604,dress,purse,crossclassified,5,3,2
7199,bed,house,crossclassified,5,4,1
7369,mirror,shelf,crossclassified,5,5,0
4599,fruit,glass,crossclassified,5,1,4
7205,duplex,house,hypernymy.2,5,0,5
4579,horse,pen,crossclassified,5,0,5
699,camera,shirt,crossclassified,5,0,5
4571,boyfriend,man,hypernymy.2,5,0,5
4570,bench,skirt,crossclassified,5,5,0
700,blender,silverware,crossclassified,5,5,0
7337,boy,fence,crossclassified,5,1,4
7333,house,sheep,crossclassified,5,5,0
7325,knife,utensils,crossclassified,5,5,0
708,blender,bowl,crossclassified,5,5,0
13549,boy,spoon,crossclassified,5,5,0
7270,bowl,wok,crossclassified,5,3,2
4555,chair,horse,crossclassified,5,5,0
4550,animal,man,hypernymy.1,5,0,5
4536,lady,person,hypernymy.2,5,0,5
4615,bathtub,curtain,crossclassified,5,2,3
7166,giraffe,wood,crossclassified,5,5,0
7035,jug,pitcher,co-hyponymy,5,0,5
4475,counter,tabletop,crossclassified,5,5,0
13445,cover,motorcycle,crossclassified,5,0,5
7537,cupboard,door,crossclassified,5,0,5
4685,ground,runway,crossclassified,5,0,5
7055,broccoli,plate,crossclassified,5,5,0
7530,cheese,woman,crossclassified,5,0,5
7527,apple,lettuce,crossclassified,5,0,5
7522,bookshelf,cupboard,crossclassified,5,5,0
4678,boy,fork,crossclassified,5,5,0
4676,desk,peripherals,crossclassified,5,5,0
7513,foods,table,hypernymy.1,5,0,5
654,train,wire,crossclassified,5,5,0
4435,bottle,cleaner,crossclassified,5,5,0
1468,spoon,utensil,crossclassified,5,5,0
7077,coat,raincoat,hypernymy.1,5,5,0
7450,food,granola,hypernymy.1,5,5,0
792,animal,hat,crossclassified,5,0,5
4655,bowl,fo,crossclassified,5,5,0
1489,pizza,plat,crossclassified,5,5,0
7133,rose,table,crossclassified,5,0,5
7156,plant,tree,hypernymy.1,5,5,0
4621,house,structure,hypernymy.2,5,5,0
6802,bookshelf,shelving,crossclassified,5,5,0
6792,sidecar,wheel,crossclassified,5,5,0
5131,mike,shirt,crossclassified,5,0,5
6418,casserole,salad,co-hyponymy,5,0,5
5065,salad,spinach,crossclassified,5,5,0
5063,girl,teen,crossclassified,5,5,0
5046,beach,boardwalk,crossclassified,5,5,0
15767,clock,window,crossclassified,5,5,0
14881,taxi,truck,crossclassified,5,0,5
6388,lemon,lime,co-hyponymy,5,3,2
6391,dish,pan,co-hyponymy,5,2,3
6392,cloth,couch,crossclassified,5,0,5
5039,brush,girl,crossclassified,5,0,5
8041,cabinet,countertop,crossclassified,5,5,0
1685,couch,cover,crossclassified,5,5,0
6790,sidecar,vehicle,co-hyponymy,5,5,0
5024,fence,giraffe,crossclassified,5,0,5
4134,cap,couch,crossclassified,5,0,5
6448,man,turban,crossclassified,5,0,5
8033,cabinets,table,co-hyponymy,5,5,0
5011,bridge,ladder,crossclassified,5,5,0
8027,bench,box,co-hyponymy,5,4,1
13950,groom,suit,crossclassified,5,0,5
4988,glove,gloves,synonymy,5,5,0
7974,shirt,wrap,crossclassified,5,5,0
6516,bookshelf,sofa,crossclassified,5,5,0
6323,desk,lamp,crossclassified,5,4,1
956,boat,marina,crossclassified,5,2,3
6300,water,wave,crossclassified,5,0,5
6290,desk,pot,crossclassified,5,5,0
13135,fork,utensil,crossclassified,5,5,0
14902,salad,shrimp,crossclassified,5,5,0
1734,giraffe,rig,crossclassified,5,5,0
5130,girl,infant,crossclassified,5,5,0
5128,chair,train,crossclassified,5,2,3
6254,dirt,mound,crossclassified,5,4,1
4060,dugout,jacket,crossclassified,5,5,0
4061,banner,dugout,crossclassified,5,0,5
8147,bench,shelf,crossclassified,5,5,0
4074,shop,truck,crossclassified,5,0,5
13167,cookie,sandwich,crossclassified,5,4,1
6262,chair,pants,crossclassified,5,5,0
4081,grill,tray,crossclassified,5,2,3
962,reflection,woman,crossclassified,5,0,5
4082,pizzas,tray,crossclassified,5,0,5
6271,helicopter,propeller,crossclassified,5,4,1
14527,glass,phone,crossclassified,5,5,0
4092,person,tie,crossclassified,5,1,4
6273,bridge,underpass,crossclassified,5,5,0
5108,plate,vegetables,crossclassified,5,5,0
14889,elephant,hat,crossclassified,5,5,0
1663,bridge,footbridge,hypernymy.1,5,5,0
15710,bicycle,bike,synonymy,5,0,5
13936,cinderella,woman,hypernymy.2,5,5,0
4901,animal,oxen,crossclassified,5,5,0
6653,breakfast,toast,crossclassified,5,0,5
7866,ball,bear,crossclassified,5,0,5
6656,donut,man,crossclassified,5,1,4
568,boat,motorboat,hypernymy.1,5,5,0
7859,hood,wheel,crossclassified,5,5,0
569,boat,speedboat,hypernymy.1,5,5,0
7847,bowl,tomato,crossclassified,5,5,0
1619,girl,hat,crossclassified,5,5,0
13303,bread,burrito,crossclassified,5,0,5
13304,burrito,tortilla,crossclassified,5,5,0
14608,bike,rug,crossclassified,5,0,5
1414,paper,shirt,crossclassified,5,0,5
6667,carpet,tiles,crossclassified,5,5,0
4259,cup,shirt,crossclassified,5,0,5
6668,chair,face,crossclassified,5,5,0
13311,fish,pizza,crossclassified,5,4,1
6687,dog,fur,crossclassified,5,5,0
6691,boat,watercraft,hypernymy.2,5,5,0
4266,kid,player,crossclassified,5,0,5
6731,bread,man,crossclassified,5,0,5
14628,coral,fish,crossclassified,5,5,0
7874,carpet,doll,crossclassified,5,5,0
4904,animal,yak,crossclassified,5,5,0
4180,wine,woman,crossclassified,5,0,5
4910,broccoli,pasta,crossclassified,5,1,4
1371,pan,table,crossclassified,5,1,4
1374,doughnuts,table,crossclassified,5,0,5
4186,sculpture,statue,hypernymy.1,5,0,5
1658,airplane,jets,hypernymy.1,5,5,0
13263,head,hood,co-hyponymy,5,0,5
7932,boat,vehicles,hypernymy.2,5,5,0
7926,motorcycle,toy,crossclassified,5,5,0
4958,cheese,pie,crossclassified,5,3,2
6546,flower,iris,crossclassified,5,5,0
13921,food,omelet,hypernymy.1,5,5,0
4945,airplane,turboprop,hypernymy.1,5,5,0
7914,cabinet,handle,crossclassified,5,5,0
4931,shirt,tuxedo,crossclassified,5,5,0
13272,highchair,shirt,crossclassified,5,5,0
1382,lunch,sandwich,crossclassified,5,0,5
6594,bench,paper,crossclassified,5,5,0
4211,cake,person,crossclassified,5,0,5
7895,building,painting,crossclassified,5,5,0
6623,candle,table,crossclassified,5,0,5
15564,cap,statue,crossclassified,5,0,5
1404,rice,table,crossclassified,5,1,4
7034,hat,shirt,crossclassified,5,2,3
5544,pen,shirt,crossclassified,5,0,5
8681,house,houses,synonymy,5,5,0
9809,dishes,table,crossclassified,5,0,5
2091,apple,child,crossclassified,5,0,5
3156,bowl,lemon,crossclassified,5,5,0
9948,dugout,steps,crossclassified,5,5,0
3177,seat,woman,crossclassified,5,0,5
9922,cookie,granola,crossclassified,5,5,0
9913,truck,window,crossclassified,5,5,0
3184,court,field,hypernymy.2,5,5,0
3185,court,floor,co-hyponymy,5,3,2
12197,desk,pant,crossclassified,5,5,0
12199,desk,wheel,crossclassified,5,5,0
12238,airplane,tail,crossclassified,5,5,0
9793,cereal,soup,crossclassified,5,4,1
9968,house,temple,co-hyponymy,5,1,4
9780,building,pagoda,hypernymy.1,5,5,0
12276,bottle,train,crossclassified,5,0,5
3259,boy,car,crossclassified,5,3,2
9756,cookie,doll,crossclassified,5,5,0
3266,sandal,woman,crossclassified,5,0,5
12293,shoes,table,crossclassified,5,0,5
2059,cucumber,zucchini,crossclassified,5,5,0
9700,couch,skirt,crossclassified,5,5,0
12318,stairs,truck,crossclassified,5,0,5
12319,boat,wagon,crossclassified,5,5,0
9660,plate,sink,crossclassified,5,0,5
9956,dress,pyjamas,crossclassified,5,5,0
9972,bat,person,crossclassified,5,2,3
11954,keyboard,rug,crossclassified,5,0,5
10077,bathtub,legs,crossclassified,5,5,0
3001,man,robe,crossclassified,5,1,4
11974,bed,screen,co-hyponymy,5,5,0
10223,cow,jacket,crossclassified,5,5,0
3022,jar,table,crossclassified,5,0,5
12018,cart,wheel,co-hyponymy,5,5,0
12026,carriage,cart,co-hyponymy,5,4,1
10154,fries,table,crossclassified,5,0,5
3054,bridge,van,crossclassified,5,5,0
3057,reproach,zebra,crossclassified,5,0,5
10131,bird,woodpecker,hypernymy.1,5,5,0
3077,bag,dresser,crossclassified,5,0,5
10070,catcher,human,crossclassified,5,5,0
9977,cat,wood,crossclassified,5,5,0
3090,carrots,umbrella,crossclassified,5,0,5
10066,cabinet,cup,crossclassified,5,5,0
10056,carpet,ground,crossclassified,5,5,0
3098,couch,keyboard,crossclassified,5,5,0
10052,banana,grill,crossclassified,5,0,5
2107,snack,table,crossclassified,5,0,5
3117,goat,horn,crossclassified,5,5,0
3120,net,woman,crossclassified,5,0,5
3136,bottle,container,hypernymy.2,5,2,3
12153,cat,towel,crossclassified,5,5,0
12156,cabinet,jacket,crossclassified,5,5,0
3330,earring,woman,crossclassified,5,0,5
9639,box,donuts,crossclassified,5,4,1
9623,cake,snakes,crossclassified,5,5,0
9183,bangle,dress,crossclassified,5,0,5
3507,bowl,peaches,crossclassified,5,5,0
1938,man,pen,crossclassified,5,5,0
12548,brush,crib,crossclassified,5,0,5
9239,motorcycle,pant,crossclassified,5,5,0
12551,child,crib,crossclassified,5,0,5
9217,hut,outhouse,crossclassified,5,1,4
9208,dough,food,hypernymy.2,5,4,1
3552,hood,jacket,crossclassified,5,1,4
3553,pant,skater,crossclassified,5,0,5
9187,rug,wooden,crossclassified,5,5,0
3556,bomber,plane,hypernymy.2,5,0,5
12596,carpet,toys,crossclassified,5,5,0
9622,bowl,snakes,crossclassified,5,5,0
9147,leaf,vegetables,crossclassified,5,0,5
9133,booth,game,crossclassified,5,0,5
9132,game,toy,crossclassified,5,5,0
12609,cake,highchair,crossclassified,5,0,5
9123,jacket,spoon,crossclassified,5,5,0
1906,curtain,towel,crossclassified,5,5,0
3587,cat,statue,crossclassified,5,3,2
9103,pen,table,crossclassified,5,0,5
3606,girl,head,crossclassified,5,5,0
9079,head,person,hypernymy.2,5,5,0
9077,book,head,crossclassified,5,0,5
1942,floor,phone,crossclassified,5,5,0
9294,cook,shirt,crossclassified,5,0,5
15792,leek,vegetable,hypernymy.2,5,5,0
3479,calf,sheep,crossclassified,5,0,5
3339,cabinet,toilet,crossclassified,5,5,0
9618,building,statue,crossclassified,5,5,0
9597,bird,stone,crossclassified,5,5,0
9587,couch,shower,crossclassified,5,5,0
3362,squire,squirrel,crossclassified,5,0,5
2009,dress,hand,crossclassified,5,5,0
3376,lama,llama,crossclassified,5,0,5
9530,pant,table,crossclassified,5,0,5
9496,bench,house,crossclassified,5,1,4
9483,donut,pizza,crossclassified,5,5,0
9448,bed,room,crossclassified,5,5,0
12436,bananas,table,crossclassified,5,0,5
9424,road,truck,crossclassified,5,0,5
3427,hat,horse,crossclassified,5,0,5
12450,carpet,food,crossclassified,5,5,0
12452,couch,legs,crossclassified,5,5,0
9386,teddy,toy,hypernymy.2,5,0,5
3444,grill,oven,crossclassified,5,3,2
12465,counter,donuts,crossclassified,5,5,0
9377,boy,pillow,crossclassified,5,5,0
3461,graduate,man,crossclassified,5,0,5
3466,curtain,drapery,synonymy,5,5,0
1958,drink,wine,hypernymy.1,5,0,5
3000,bed,robe,crossclassified,5,0,5
10305,board,plank,synonymy,5,5,0
3619,cat,pole,crossclassified,5,5,0
11540,glass,train,crossclassified,5,0,5
11055,keyboard,person,crossclassified,5,5,0
2360,computer,couch,crossclassified,5,0,5
2585,areopagite,plane,crossclassified,5,0,5
2587,hotdog,onion,crossclassified,5,5,0
2591,hotdog,toppings,crossclassified,5,5,0
11017,jeans,table,crossclassified,5,0,5
11530,shelf,vase,crossclassified,5,1,4
11013,car,sidewalk,crossclassified,5,5,0
2603,bird,pizza,crossclassified,5,0,5
11007,camera,television,crossclassified,5,5,0
10996,glass,truck,crossclassified,5,0,5
11544,boat,cow,crossclassified,5,5,0
11085,bookshelf,parrot,crossclassified,5,5,0
11552,person,phone,crossclassified,5,5,0
11553,person,remote,crossclassified,5,5,0
10965,counter,tie,crossclassified,5,5,0
11574,bench,shirts,crossclassified,5,5,0
10947,bench,train,crossclassified,5,3,2
10939,couch,flowerpot,crossclassified,5,5,0
74,dugout,ground,crossclassified,5,5,0
10902,banana,bananas,synonymy,5,5,0
11603,couch,remoteness,crossclassified,5,5,0
81,dugout,rail,crossclassified,5,5,0
10874,banana,monkey,crossclassified,5,0,5
11069,animal,pig,hypernymy.1,5,0,5
2546,booth,plate,crossclassified,5,1,4
2147,man,paper,crossclassified,5,5,0
2491,surface,table,crossclassified,5,0,5
11353,canopy,giraffe,crossclassified,5,0,5
2446,couple,shirt,crossclassified,5,5,0
15371,t-shirt,window,crossclassified,5,0,5
11304,bathroom,tub,crossclassified,5,0,5
11275,pant,snowboarder,crossclassified,5,0,5
11272,tray,woman,crossclassified,5,0,5
11379,chair,tile,crossclassified,5,5,0
11391,curtain,tie,crossclassified,5,5,0
2484,table,toothbrush,crossclassified,5,5,0
11408,patio,table,crossclassified,5,5,0
11213,cup,tea,crossclassified,5,1,4
11200,chair,pole,crossclassified,5,5,0
2543,cart,train,crossclassified,5,0,5
11187,cabinet,plate,crossclassified,5,5,0
11182,banana,truck,crossclassified,5,0,5
11179,boys,man,hypernymy.2,5,0,5
11178,dresser,vase,crossclassified,5,1,4
2396,chair,suit,crossclassified,5,5,0
11438,fork,spun,crossclassified,5,5,0
11167,bike,person,crossclassified,5,3,2
11160,car,machine,synonymy,5,5,0
11152,building,curtain,crossclassified,5,2,3
2525,cat,umbrella,crossclassified,5,4,1
11149,counter,tiles,crossclassified,5,5,0
10868,lateen,sink,crossclassified,5,0,5
10859,flowerpot,pot,synonymy,5,0,5
2682,fedora,hat,hypernymy.2,5,0,5
2895,aqueduct,bridge,crossclassified,5,0,5
2212,headlight,train,crossclassified,5,0,5
2211,desk,wooden,crossclassified,5,5,0
2857,shirt,shirtsleeve,crossclassified,5,5,0
15253,cop,man,crossclassified,5,0,5
10544,bed,box,crossclassified,5,5,0
2203,tank,train,crossclassified,5,0,5
2201,couch,grill,crossclassified,5,5,0
2198,beard,shirt,crossclassified,5,2,3
2193,cup,spoon,co-hyponymy,5,0,5
2888,hotdog,man,crossclassified,5,0,5
11815,cabinet,shelving,crossclassified,5,5,0
10462,blanket,leg,crossclassified,5,5,0
11635,door,oven,crossclassified,5,0,5
11852,bidet,urinal,crossclassified,5,3,2
2920,jacket,player,crossclassified,5,4,1
11855,floor,turf,crossclassified,5,5,0
11872,floor,pillow,crossclassified,5,5,0
2936,cardigan,jacket,crossclassified,5,0,5
10399,clock,table,crossclassified,5,2,3
2948,plate,tent,crossclassified,5,0,5
2949,cape,tent,crossclassified,5,0,5
2956,burger,cheese,crossclassified,5,1,4
181,man,outfit,crossclassified,5,5,0
11903,clock,tower,crossclassified,5,5,0
15260,headphone,jacket,crossclassified,5,0,5
10596,kettle,mixer,crossclassified,5,5,0
10602,kettle,pitcher,co-hyponymy,5,5,0
11745,kitchen,oven,crossclassified,5,0,5
11639,oven,rug,crossclassified,5,5,0
15818,pants,player,crossclassified,5,5,0
10797,cow,wheel,crossclassified,5,5,0
2720,building,ship,crossclassified,5,4,1
2286,coat,horse,crossclassified,5,0,5
2283,bear,jacket,crossclassified,5,0,5
2277,bird,wooden,crossclassified,5,5,0
10742,fish,table,crossclassified,5,0,5
2273,building,shirt,crossclassified,5,5,0
2749,dog,wooden,crossclassified,5,5,0
2753,cake,icing,crossclassified,5,5,0
2760,coat,person,crossclassified,5,1,4
11713,beard,face,co-hyponymy,5,1,4
2769,jacket,umbrella,crossclassified,5,5,0
10693,house,train,crossclassified,5,2,3
2776,man,talker,crossclassified,5,5,0
15813,statue,zebra,crossclassified,5,0,5
10664,bathtub,lateen,crossclassified,5,5,0
15269,fence,railing,co-hyponymy,5,5,0
10651,sink,washermen,crossclassified,5,5,0
2808,chair,newspaper,crossclassified,5,5,0
10645,cupboard,shelf,crossclassified,5,0,5
2814,plane,shirt,crossclassified,5,5,0
9070,curtain,furniture,co-hyponymy,5,5,0
15188,foot,table,crossclassified,5,0,5
398,crust,plate,hypernymy.1,5,5,0
8727,chair,rocker,hypernymy.1,5,5,0
8700,banana,child,crossclassified,5,0,5
3637,girl,pole,crossclassified,5,5,0
343,counter,washingtonian,crossclassified,5,5,0
3649,board,car,crossclassified,5,0,5
3752,glass,pizza,crossclassified,5,0,5
8840,child,dog,crossclassified,5,5,0
1889,pillow,shirt,crossclassified,5,1,4
12753,birdbath,water,crossclassified,5,5,0
8767,horse,tail,crossclassified,5,5,0
8991,bird,keyboard,crossclassified,5,5,0
3759,key,knife,crossclassified,5,0,5
12751,birdbath,bowl,crossclassified,5,5,0
8844,carrot,sauce,crossclassified,5,0,5
8883,blanket,shoe,crossclassified,5,5,0
12743,bowl,juicer,crossclassified,5,0,5
1859,hat,skateboarder,crossclassified,5,0,5
3700,hotdogs,shirt,crossclassified,5,0,5
12646,bed,suit,crossclassified,5,5,0
11612,hutch,shelf,crossclassified,4,0,4
4553,carpet,room,crossclassified,4,4,0
230,bird,bridge,crossclassified,4,4,0
10444,cat,room,crossclassified,4,4,0
2641,guy,snowboarder,crossclassified,4,0,4
4548,dress,watch,crossclassified,4,4,0
3220,bowl,box,co-hyponymy,4,4,0
3219,bent,bowl,crossclassified,4,0,4
15303,cake,robe,crossclassified,4,0,4
10935,man,spectator,crossclassified,4,4,0
3216,boy,tree,crossclassified,4,4,0
4543,carrot,soup,crossclassified,4,0,4
4556,knife,tie,crossclassified,4,2,2
2644,shirt,snowboarder,crossclassified,4,0,4
14463,couch,tress,crossclassified,4,4,0
9833,boy,suit,crossclassified,4,2,2
10930,counter,shoe,crossclassified,4,4,0
11586,aquarium,bed,crossclassified,4,4,0
739,counter,faucet,crossclassified,4,4,0
14472,boat,bot,crossclassified,4,4,0
9838,cow,fields,crossclassified,4,4,0
2671,desk,hutch,crossclassified,4,4,0
14731,awning,bridge,crossclassified,4,4,0
3225,dog,lab,crossclassified,4,4,0
10445,box,rug,crossclassified,4,1,3
3725,sandwich,veg,crossclassified,4,4,0
5286,station,train,crossclassified,4,0,4
10688,car,tree,crossclassified,4,4,0
7316,hat,jacket,crossclassified,4,1,3
3673,cat,mouse,crossclassified,4,4,0
4527,teacher,woman,crossclassified,4,0,4
14048,electronics,mouse,crossclassified,4,0,4
12249,chair,stand,crossclassified,4,1,3
15587,board,boy,crossclassified,4,0,4
11573,cabinet,tie,crossclassified,4,4,0
6645,smile,woman,crossclassified,4,0,4
13621,stroller,wheel,co-hyponymy,4,4,0
7305,bowl,ice,crossclassified,4,4,0
5962,cake,salad,co-hyponymy,4,1,3
14041,hut,pavilion,crossclassified,4,4,0
15528,phone,restaurant,crossclassified,4,0,4
2070,monad,motorcycle,crossclassified,4,0,4
7298,shirt,smile,crossclassified,4,4,0
11575,boy,foods,crossclassified,4,4,0
7296,cow,mammal,hypernymy.2,4,4,0
14710,foods,pizza,hypernymy.1,4,0,4
4567,peel,pizza,crossclassified,4,0,4
5996,blender,processor,crossclassified,4,4,0
12237,arm,bench,crossclassified,4,0,4
10417,chair,pot,crossclassified,4,4,0
7218,container,dish,hypernymy.1,4,0,4
6284,face,shirt,crossclassified,4,1,3
3856,boy,brother,crossclassified,4,4,0
14165,grass,grill,crossclassified,4,0,4
9866,donut,snack,crossclassified,4,4,0
1845,cubicle,desk,crossclassified,4,0,4
9868,shirt,snakes,crossclassified,4,4,0
13603,bedroom,window,crossclassified,4,0,4
7208,broccoli,cucumber,crossclassified,4,4,0
10890,boat,laptop,crossclassified,4,4,0
3195,banana,floor,crossclassified,4,0,4
5251,bucket,fruit,crossclassified,4,4,0
5250,apple,bucket,crossclassified,4,0,4
7200,giraffe,tongue,crossclassified,4,4,0
9898,desk,monster,crossclassified,4,4,0
6018,children,skateboarder,crossclassified,4,0,4
13611,storefront,wheel,crossclassified,4,4,0
10889,chaise,couch,crossclassified,4,0,4
10899,floor,pant,crossclassified,4,4,0
7239,animal,reindeer,hypernymy.1,4,4,0
9902,couch,gamer,crossclassified,4,4,0
7240,animal,moose,hypernymy.1,4,1,3
6039,boy,youth,crossclassified,4,4,0
7256,bowl,tub,co-hyponymy,4,4,0
3675,bag,building,crossclassified,4,0,4
9840,building,structure,hypernymy.2,4,4,0
9842,helmet,horse,crossclassified,4,0,4
8583,motorcycles,wheel,crossclassified,4,4,0
3206,egg,pizza,crossclassified,4,0,4
5287,chair,throne,hypernymy.1,4,4,0
2257,house,person,crossclassified,4,4,0
4575,corral,pen,hypernymy.2,4,0,4
8976,boat,dress,crossclassified,4,4,0
9905,carpet,cushion,crossclassified,4,4,0
771,shawl,shirt,crossclassified,4,0,4
2653,cat,dress,crossclassified,4,4,0
3205,earring,jacket,crossclassified,4,0,4
10440,meter,windshield,crossclassified,4,0,4
4900,animal,wildebeest,crossclassified,4,4,0
12809,bear,statue,crossclassified,4,4,0
7241,animal,deer,hypernymy.1,4,4,0
9802,boat,steamboat,hypernymy.1,4,4,0
14454,tyre,van,crossclassified,4,0,4
2339,bleachers,dugout,crossclassified,4,0,4
5869,girl,net,crossclassified,4,4,0
8615,man,short,crossclassified,4,4,0
5874,cabinet,lamp,co-hyponymy,4,0,4
7483,cup,man,crossclassified,4,0,4
3283,pasta,soup,co-hyponymy,4,0,4
4449,truck,windshield,crossclassified,4,4,0
7477,knife,wood,crossclassified,4,4,0
5875,doorway,train,crossclassified,4,0,4
660,trouser,woman,crossclassified,4,0,4
13476,bag,robe,crossclassified,4,0,4
9711,awning,shelter,hypernymy.2,4,3,1
7463,board,woman,crossclassified,4,0,4
7462,mobilization,woman,crossclassified,4,0,4
13479,bear,watch,crossclassified,4,4,0
7459,lamp,vase,crossclassified,4,1,3
6588,bridge,station,crossclassified,4,4,0
3280,chicken,pan,crossclassified,4,0,4
9713,awning,platform,crossclassified,4,4,0
1049,apple,orange,crossclassified,4,4,0
13489,actress,woman,crossclassified,4,0,4
15775,car,snow,crossclassified,4,4,0
2346,curtain,cushion,crossclassified,4,4,0
15146,skier,skiers,synonymy,4,4,0
11731,floor,toys,crossclassified,4,4,0
3273,pita,sandwich,crossclassified,4,0,4
8367,gate,zebra,crossclassified,4,0,4
11026,bed,bird,crossclassified,4,3,1
2747,boat,harbor,crossclassified,4,4,0
10497,snack,woman,crossclassified,4,0,4
2180,man,performer,crossclassified,4,4,0
2908,legs,skater,crossclassified,4,0,4
405,pizza,vegetables,crossclassified,4,3,1
14228,building,watch,crossclassified,4,4,0
8617,dog,house,crossclassified,4,1,3
7515,bag,dog,co-hyponymy,4,0,4
2047,cat,sand,crossclassified,4,4,0
14439,lamp,window,crossclassified,4,4,0
2593,hat,table,crossclassified,4,1,3
7510,bowl,sandwich,crossclassified,4,2,2
4933,boy,men,hypernymy.2,4,4,0
6587,man,pot,crossclassified,4,4,0
12309,bottle,keyboard,crossclassified,4,4,0
7502,mixer,pitcher,crossclassified,4,0,4
7499,baseball,boy,crossclassified,4,0,4
2595,bowl,muffin,crossclassified,4,4,0
2049,customer,woman,crossclassified,4,0,4
4440,oven,table,crossclassified,4,3,1
6306,bread,hand,crossclassified,4,3,1
4469,man,politician,crossclassified,4,4,0
9798,catcher,jacket,crossclassified,4,4,0
3257,snow,snowboarder,crossclassified,4,0,4
7373,body,jacket,crossclassified,4,0,4
3256,skating,snowboarder,crossclassified,4,0,4
4499,deer,goat,crossclassified,4,0,4
8600,dog,glass,crossclassified,4,4,0
5933,bench,floor,crossclassified,4,1,3
8372,bowl,water,crossclassified,4,4,0
8885,blanket,poncho,crossclassified,4,4,0
10687,couch,fruit,crossclassified,4,4,0
4916,bench,kid,crossclassified,4,4,0
7357,carafe,vase,crossclassified,4,0,4
11543,system,table,crossclassified,4,0,4
3825,boat,pier,crossclassified,4,4,0
9789,cupboard,oven,crossclassified,4,0,4
6624,dugout,steel,crossclassified,4,4,0
8598,book,counter,crossclassified,4,0,4
12912,jacket,lady,crossclassified,4,4,0
5095,fruit,stand,crossclassified,4,4,0
10873,bowl,macaroni,crossclassified,4,4,0
2256,house,leaf,crossclassified,4,4,0
6628,ski,skier,crossclassified,4,0,4
4518,canopy,hut,crossclassified,4,0,4
6619,building,jacket,crossclassified,4,2,2
3857,bag,boy,crossclassified,4,0,4
5904,hood,vehicle,crossclassified,4,4,0
11842,couch,couple,crossclassified,4,4,0
15319,hand,phone,crossclassified,4,4,0
3269,bird,cardinal,hypernymy.1,4,4,0
5905,hood,shirt,crossclassified,4,4,0
7425,counter,wire,crossclassified,4,4,0
2602,sheep,shirt,crossclassified,4,3,1
5091,car,dress,crossclassified,4,4,0
4478,arm,person,crossclassified,4,3,1
7413,cat,rope,crossclassified,4,4,0
10483,table,teddy,crossclassified,4,4,0
14444,curtain,star,crossclassified,4,4,0
10482,girl,sofa,crossclassified,4,4,0
11536,cup,foods,hypernymy.2,4,4,0
7404,boat,pontoon,hypernymy.1,4,4,0
6597,girl,mobile,crossclassified,4,4,0
5309,hat,mask,crossclassified,4,1,3
13905,boy,orange,crossclassified,4,4,0
7388,actor,man,co-hyponymy,4,0,4
9749,boat,tower,hypernymy.1,4,4,0
3668,fence,house,crossclassified,4,0,4
1873,chest,table,co-hyponymy,4,0,4
11537,cup,milk,crossclassified,4,4,0
6046,art,horse,crossclassified,4,0,4
7144,van,window,crossclassified,4,4,0
6052,catcher,dress,crossclassified,4,4,0
12033,knife,tomato,crossclassified,4,1,3
12052,scooter,shoe,crossclassified,4,4,0
6721,bowl,pistachios,crossclassified,4,4,0
4759,bowl,shelf,crossclassified,4,0,4
6915,donuts,plate,crossclassified,4,0,4
2148,man,plumber,crossclassified,4,4,0
6912,bikini,woman,crossclassified,4,0,4
3050,boat,surfboard,crossclassified,4,2,2
12037,table,vanity,hypernymy.1,4,1,3
5171,child,clothing,crossclassified,4,4,0
12035,animal,truck,crossclassified,4,0,4
6905,cat,lion,hypernymy.1,4,0,4
14530,cellphone,glass,crossclassified,4,0,4
2756,handle,sink,crossclassified,4,0,4
12028,chair,kite,crossclassified,4,4,0
3040,plate,pot,co-hyponymy,4,0,4
11662,counter,drink,crossclassified,4,4,0
1800,buggy,truck,crossclassified,4,0,4
1890,bag,pillow,crossclassified,4,0,4
4776,sheep,ship,crossclassified,4,3,1
3038,carpet,window,crossclassified,4,4,0
12022,cargo,cart,crossclassified,4,0,4
5167,bread,pan,crossclassified,4,0,4
4860,bread,crust,crossclassified,4,2,2
1424,bridge,city,crossclassified,4,4,0
10336,balcony,planter,crossclassified,4,0,4
2967,boxcars,train,crossclassified,4,0,4
10805,ground,wheel,crossclassified,4,0,4
821,biscuit,sandwich,crossclassified,4,0,4
6156,horse,table,crossclassified,4,3,1
14671,sweater,toilet,crossclassified,4,4,0
10802,bike,wheel,synonymy,4,0,4
204,floor,shoes,crossclassified,4,4,0
15817,pants,person,crossclassified,4,4,0
12062,rack,shelf,co-hyponymy,4,1,3
6693,ball,dugout,crossclassified,4,0,4
6699,exhaust,vent,crossclassified,4,0,4
3070,bread,pancakes,crossclassified,4,1,3
11657,bowl,burger,crossclassified,4,4,0
10122,glass,mirror,hypernymy.2,4,0,4
3065,bun,man,crossclassified,4,0,4
882,building,streetlight,crossclassified,4,0,4
6259,guitarist,man,crossclassified,4,0,4
6951,jacket,tux,crossclassified,4,4,0
10132,carpet,seat,crossclassified,4,4,0
4749,cat,catcher,crossclassified,4,4,0
10139,awning,dugout,crossclassified,4,0,4
12728,bathroom,shower,crossclassified,4,0,4
4855,container,jar,hypernymy.1,4,0,4
12020,cart,wagon,hypernymy.2,4,4,0
10333,jersey,player,crossclassified,4,0,4
11682,bowl,rug,crossclassified,4,0,4
13794,bookshelf,vase,crossclassified,4,4,0
4813,booth,person,crossclassified,4,4,0
11931,bicycle,truck,crossclassified,4,0,4
3010,alcohol,bottle,crossclassified,4,0,4
15814,bat,pants,crossclassified,4,0,4
10268,curtain,teddy,crossclassified,4,4,0
3005,gate,sheep,crossclassified,4,0,4
3848,meal,pasta,crossclassified,4,0,4
6808,bench,toys,crossclassified,4,4,0
11956,electronics,rug,crossclassified,4,0,4
6797,car,taillight,crossclassified,4,4,0
10730,dog,pant,crossclassified,4,4,0
10289,couch,shophar,crossclassified,4,4,0
2138,cloth,umbrella,crossclassified,4,0,4
10291,dresser,glass,crossclassified,4,4,0
13834,clock,watch,co-hyponymy,4,4,0
6781,bird,geese,hypernymy.1,4,4,0
4832,bench,leash,crossclassified,4,4,0
5136,bread,snacks,crossclassified,4,4,0
10303,board,wall,crossclassified,4,1,3
878,equine,horse,hypernymy.1,4,0,4
6216,bed,pants,crossclassified,4,4,0
12939,celery,rhubarb,co-hyponymy,4,0,4
1444,juice,shirt,crossclassified,4,0,4
8563,light,woman,crossclassified,4,0,4
10785,antique,truck,crossclassified,4,0,4
10204,chair,sandwich,crossclassified,4,3,1
14077,fence,motorcycle,crossclassified,4,0,4
14652,bridge,skateboarder,crossclassified,4,4,0
2282,jacket,paper,crossclassified,4,4,0
10325,building,crow,crossclassified,4,4,0
3025,coleslaw,hotdog,crossclassified,4,0,4
10780,banana,cat,crossclassified,4,0,4
3023,picnic,table,crossclassified,4,0,4
1435,taxi,van,crossclassified,4,4,0
1862,bridge,stone,crossclassified,4,4,0
13756,benches,chair,co-hyponymy,4,4,0
10776,bench,trouser,crossclassified,4,4,0
10775,dog,sea,crossclassified,4,4,0
8904,t-shirt,tie,crossclassified,4,0,4
8475,bookcase,cabinet,co-hyponymy,4,0,4
3017,helmet,van,crossclassified,4,0,4
6853,pan,platter,crossclassified,4,4,0
6735,man,scoreboard,crossclassified,4,2,2
6251,bike,dress,crossclassified,4,0,4
10248,baseball,dugout,crossclassified,4,0,4
14615,cabinet,outhouse,crossclassified,4,4,0
13713,blender,table,crossclassified,4,2,2
5192,man,ring,crossclassified,4,4,0
6071,husband,man,crossclassified,4,0,4
12162,pillow,sofa,crossclassified,4,0,4
2093,china,table,crossclassified,4,4,0
15435,hart,woman,crossclassified,4,0,4
7084,bench,shorts,crossclassified,4,4,0
5114,men,truck,crossclassified,4,0,4
5221,couch,wall,crossclassified,4,4,0
15604,boy,scissor,crossclassified,4,4,0
4658,airplane,road,crossclassified,4,4,0
5220,couch,television,crossclassified,4,4,0
12157,chair,cloth,crossclassified,4,4,0
8417,child,pillow,crossclassified,4,4,0
10699,drink,soda,hypernymy.1,4,1,3
8690,curtain,watch,crossclassified,4,4,0
8487,jacket,sleeveless,crossclassified,4,4,0
13002,bus,tram,crossclassified,4,4,0
12149,bench,electronics,crossclassified,4,4,0
7073,shoe,skateboard,crossclassified,4,3,1
801,beverage,glass,crossclassified,4,0,4
1464,mike,suit,crossclassified,4,0,4
3132,skater,teen,crossclassified,4,4,0
977,humvee,truck,crossclassified,4,0,4
4649,desk,train,crossclassified,4,4,0
10857,plants,pot,crossclassified,4,0,4
178,floor,plate,crossclassified,4,4,0
2683,noodles,table,crossclassified,4,0,4
12177,child,motorcycle,crossclassified,4,0,4
6272,helicopter,wings,crossclassified,4,4,0
9945,railway,tracks,hypernymy.2,4,0,4
2085,shirt,window,crossclassified,4,3,1
3306,cake,cream,crossclassified,4,4,0
6059,boy,racket,crossclassified,4,4,0
12175,suv,vehicle,hypernymy.2,4,4,0
3162,animals,dog,hypernymy.1,4,0,4
12696,bed,hair,crossclassified,4,4,0
7132,bottle,sink,crossclassified,4,0,4
2770,banana,boat,crossclassified,4,0,4
9949,dugout,stairs,crossclassified,4,4,0
3838,meal,salad,crossclassified,4,0,4
9952,giraffe,leaves,crossclassified,4,4,0
8896,desk,pole,crossclassified,4,4,0
8409,apple,pear,co-hyponymy,4,4,0
1772,machine,table,crossclassified,4,0,4
3154,bathrobe,shirt,crossclassified,4,0,4
8968,herd,zebra,crossclassified,4,0,4
7121,animal,shirt,crossclassified,4,0,4
5228,lamp,table,co-hyponymy,4,3,1
7066,colt,horse,crossclassified,4,0,4
6102,man,specs,crossclassified,4,4,0
13706,banana,coat,crossclassified,4,4,0
3102,bridge,path,crossclassified,4,4,0
8440,screen,table,crossclassified,4,0,4
8898,bread,fork,crossclassified,4,0,4
10055,carpet,turf,crossclassified,4,4,0
7019,orange,truck,crossclassified,4,0,4
12711,sauerkraut,sausage,crossclassified,4,0,4
92,bathtub,bed,crossclassified,4,4,0
10823,boy,grass,crossclassified,4,1,3
5198,food,squash,hypernymy.1,4,0,4
8445,building,sidewalk,crossclassified,4,4,0
10820,grass,uniform,crossclassified,4,4,0
1417,counter,washington,crossclassified,4,4,0
6147,building,cycle,crossclassified,4,4,0
6998,dog,fox,co-hyponymy,4,4,0
4716,food,veg,hypernymy.1,4,4,0
8447,cake,topping,crossclassified,4,4,0
6989,drizzle,sauce,crossclassified,4,0,4
4719,bench,purse,crossclassified,4,4,0
2706,truck,woman,crossclassified,4,2,2
13704,banana,sweater,crossclassified,4,4,0
4722,chair,vase,crossclassified,4,1,3
4723,class,vase,crossclassified,4,0,4
8567,lid,toilet,crossclassified,4,0,4
8434,fork,shirt,crossclassified,4,0,4
6103,man,spectacle,crossclassified,4,4,0
2698,lanyard,shirt,crossclassified,4,0,4
3125,stripes,zebra,crossclassified,4,0,4
12132,curtain,valance,crossclassified,4,4,0
3123,bat,bed,crossclassified,4,0,4
6104,bird,seabird,hypernymy.1,4,4,0
802,glass,liquor,crossclassified,4,4,0
5211,male,person,hypernymy.2,4,0,4
2764,coat,t-shirt,crossclassified,4,4,0
1340,shelve,table,crossclassified,4,0,4
15437,boat,shopper,crossclassified,4,4,0
806,alcohol,glass,crossclassified,4,0,4
12129,couch,sweater,crossclassified,4,4,0
7037,jar,pitcher,co-hyponymy,4,0,4
11638,carpet,oven,crossclassified,4,0,4
4690,pancake,sandwich,crossclassified,4,2,2
10032,cycle,house,crossclassified,4,0,4
2103,grill,rack,co-hyponymy,4,4,0
3108,bridge,wood,crossclassified,4,4,0
12112,bar,glass,crossclassified,4,4,0
8810,bonnet,hat,hypernymy.2,4,0,4
10832,legs,woman,crossclassified,4,2,2
3104,face,girl,crossclassified,4,3,1
9674,zebra,zeroes,crossclassified,4,4,0
9678,frisbee,house,crossclassified,4,0,4
4937,skier,snowman,crossclassified,4,4,0
8021,van,vegetable,crossclassified,4,4,0
3499,dress,shoe,crossclassified,4,3,1
2412,blender,ice,crossclassified,4,4,0
14312,fruit,toaster,crossclassified,4,0,4
10560,bench,phone,crossclassified,4,4,0
9261,bag,child,crossclassified,4,0,4
523,jacket,sweet,crossclassified,4,4,0
2500,shed,wooden,crossclassified,4,4,0
11199,man,van,crossclassified,4,0,4
13234,sail,sailboat,crossclassified,4,1,3
4156,airplane,jacket,crossclassified,4,4,0
2206,rail,train,crossclassified,4,0,4
6478,player,uniform,crossclassified,4,4,0
6480,kimberlite,man,crossclassified,4,0,4
1946,bowl,grapefruit,crossclassified,4,4,0
10555,floor,tent,crossclassified,4,0,4
922,bed,kid,crossclassified,4,4,0
12844,boy,umbrella,crossclassified,4,3,1
293,dress,torso,crossclassified,4,4,0
15558,kite,kites,synonymy,4,4,0
4167,banana,cereal,crossclassified,4,0,4
11185,bridge,river,crossclassified,4,4,0
9260,bird,food,hypernymy.2,4,4,0
9256,omelette,soup,co-hyponymy,4,0,4
2867,footstool,ottoman,synonymy,4,0,4
3503,curtain,monitor,crossclassified,4,4,0
11409,furniture,patio,crossclassified,4,0,4
15766,clock,fence,crossclassified,4,4,0
13195,cupcake,shirt,crossclassified,4,0,4
14373,floor,phones,crossclassified,4,4,0
4122,bane,bench,crossclassified,4,0,4
5640,bullock,cow,co-hyponymy,4,0,4
1828,house,plant,crossclassified,4,4,0
3636,girl,women,hypernymy.2,4,4,0
4127,girl,jersey,crossclassified,4,4,0
12547,couch,kite,crossclassified,4,4,0
9242,bed,truck,crossclassified,4,0,4
12542,plate,rug,crossclassified,4,0,4
952,dock,marina,hypernymy.1,4,0,4
12538,counter,tools,crossclassified,4,4,0
8279,bookshelf,glass,crossclassified,4,4,0
14565,bull,yak,crossclassified,4,4,0
5481,boy,pole,crossclassified,4,4,0
3508,bowl,peach,crossclassified,4,4,0
5480,mensuration,suit,crossclassified,4,0,4
5645,bench,suit,crossclassified,4,4,0
3504,bird,dog,crossclassified,4,3,1
13244,food,yogurt,hypernymy.1,4,0,4
11793,boy,building,crossclassified,4,0,4
14302,bookshelf,child,crossclassified,4,4,0
1665,players,woman,crossclassified,4,0,4
5697,cellphone,jacket,crossclassified,4,0,4
7918,counter,drawer,crossclassified,4,4,0
7917,boy,candle,crossclassified,4,4,0
7916,bun,plate,crossclassified,4,4,0
15793,leek,leeks,synonymy,4,4,0
8313,scrubs,shirt,co-hyponymy,4,0,4
9356,band,girl,crossclassified,4,0,4
4989,dish,sandwich,hypernymy.1,4,0,4
7903,building,fort,crossclassified,4,4,0
9359,cabinets,sink,crossclassified,4,0,4
551,car,roadster,hypernymy.1,4,4,0
9360,sink,washington,crossclassified,4,4,0
5836,airplane,cockpit,crossclassified,4,4,0
3764,house,van,crossclassified,4,4,0
2866,ottoman,table,crossclassified,4,1,3
1637,pastry,pizza,crossclassified,4,0,4
4987,glove,knife,crossclassified,4,4,0
5708,cap,surfer,crossclassified,4,0,4
9374,dugout,men,crossclassified,4,4,0
8314,plait,table,crossclassified,4,0,4
11166,person,wheel,crossclassified,4,4,0
6500,boat,umbrella,crossclassified,4,4,0
7922,building,london,crossclassified,4,4,0
2801,boy,controller,crossclassified,4,4,0
12665,food,ingredients,hypernymy.1,4,4,0
9298,motorcycle,trailer,crossclassified,4,4,0
9302,counter,ledge,crossclassified,4,4,0
10654,boat,gondola,hypernymy.1,4,4,0
539,bird,table,crossclassified,4,1,3
1661,artist,man,crossclassified,4,0,4
4993,jam,table,crossclassified,4,0,4
7942,catcher,pant,crossclassified,4,4,0
14862,rug,vase,crossclassified,4,4,0
4183,carrot,woman,crossclassified,4,0,4
12891,shirt,tux,crossclassified,4,4,0
5451,fruit,girl,crossclassified,4,0,4
9331,horse,ride,crossclassified,4,4,0
7937,umbellate,woman,crossclassified,4,0,4
1660,man,painter,co-hyponymy,4,4,0
3770,shoe,wheelchair,crossclassified,4,0,4
5681,sheep,toy,crossclassified,4,2,2
5682,sheep,wood,crossclassified,4,4,0
7928,clock,motorcycle,crossclassified,4,0,4
14296,cake,meat,crossclassified,4,0,4
1119,car,convertible,hypernymy.1,4,4,0
13192,cat,vest,crossclassified,4,4,0
9228,sofa,tie,crossclassified,4,0,4
9224,car,helmet,crossclassified,4,4,0
1153,dress,vest,crossclassified,4,3,1
8243,banana,hotdog,crossclassified,4,0,4
13980,beach,building,crossclassified,4,0,4
1194,container,fruit,crossclassified,4,2,2
2831,man,pair,crossclassified,4,4,0
13979,bread,salad,crossclassified,4,0,4
4040,cow,painting,crossclassified,4,4,0
9116,sandwich,spinach,crossclassified,4,4,0
6428,t-shirt,umpire,crossclassified,4,0,4
9118,oranges,table,crossclassified,4,0,4
8183,mountain,wing,crossclassified,4,0,4
12617,sink,t-shirt,crossclassified,4,4,0
14906,food,pita,hypernymy.1,4,4,0
13133,runner,woman,crossclassified,4,0,4
2236,child,curtain,crossclassified,4,0,4
3580,counter,glasses,crossclassified,4,4,0
2835,dog,window,crossclassified,4,4,0
8255,counter,pole,crossclassified,4,4,0
12649,bench,mobile,crossclassified,4,4,0
6386,surfboard,woman,crossclassified,4,0,4
8164,book,shelf,crossclassified,4,0,4
2457,curtain,fence,crossclassified,4,1,3
8201,boat,pant,crossclassified,4,4,0
338,eating,girl,crossclassified,4,0,4
8207,fork,shooting,crossclassified,4,4,0
10627,ski,snow,crossclassified,4,0,4
5547,house,photograph,crossclassified,4,4,0
12953,cake,hat,crossclassified,4,4,0
5036,curtain,tapestry,crossclassified,4,4,0
4010,dress,mirror,crossclassified,4,3,1
3611,garage,man,crossclassified,4,4,0
4012,bowl,trough,synonymy,4,1,3
8238,man,orange,crossclassified,4,4,0
11753,bed,wardrobe,crossclassified,4,0,4
12870,teepee,tepee,synonymy,4,4,0
5537,competitor,man,crossclassified,4,0,4
11307,boy,boys,synonymy,4,4,0
14346,drink,jar,crossclassified,4,0,4
1192,fruit,tray,crossclassified,4,4,0
4022,table,vcr,crossclassified,4,4,0
9091,brush,toothbrush,hypernymy.1,4,0,4
5532,building,dog,crossclassified,4,3,1
1895,outfit,woman,crossclassified,4,0,4
12626,microwave,oven,co-hyponymy,4,3,1
2812,man,plane,crossclassified,4,0,4
8209,pole,roof,crossclassified,4,0,4
15770,bars,clock,crossclassified,4,0,4
5048,beach,sidewalk,crossclassified,4,4,0
4114,plant,vase,crossclassified,4,3,1
9168,rug,suitcase,crossclassified,4,0,4
8653,crane,flamingo,co-hyponymy,4,0,4
5608,bench,tree,crossclassified,4,4,0
8097,catcher,jersey,crossclassified,4,4,0
2237,plane,t-shirt,crossclassified,4,4,0
4093,sprinkles,wrapper,crossclassified,4,0,4
3987,chair,mobile,crossclassified,4,4,0
3721,girl,horse,crossclassified,4,3,1
8650,cheese,rice,crossclassified,4,0,4
5014,cabinet,stove,crossclassified,4,1,3
3547,lady,man,crossclassified,4,0,4
11397,glass,window,crossclassified,4,0,4
4101,shelving,table,crossclassified,4,0,4
10590,man,rug,crossclassified,4,1,3
8080,monitor,table,crossclassified,4,0,4
5635,car,wiper,crossclassified,4,4,0
11778,unknown,vase,crossclassified,4,0,4
1701,bridge,jacket,crossclassified,4,4,0
12561,table,toys,crossclassified,4,4,0
8265,box,cake,crossclassified,4,2,2
9032,boat,van,crossclassified,4,4,0
1207,cupcake,desert,crossclassified,4,4,0
4087,dexter,woman,crossclassified,4,0,4
12573,cabinet,flower,crossclassified,4,4,0
5602,hotdog,snack,crossclassified,4,4,0
2421,pottery,vases,crossclassified,4,4,0
5515,train,trains,synonymy,4,4,0
8154,curtain,light,crossclassified,4,4,0
8698,scissor,woman,crossclassified,4,0,4
5513,dog,dogs,synonymy,4,4,0
9169,mat,suitcase,crossclassified,4,0,4
9170,suitcase,table,crossclassified,4,1,3
6378,man,statue,crossclassified,4,1,3
1716,cow,t-shirt,crossclassified,4,4,0
6375,child,food,crossclassified,4,4,0
14332,meter,woman,crossclassified,4,0,4
3790,floor,pants,crossclassified,4,4,0
13162,hat,house,crossclassified,4,0,4
13163,catcher,woman,crossclassified,4,0,4
8119,coat,truck,crossclassified,4,0,4
1203,cow,donkey,crossclassified,4,4,0
1749,gravy,plate,crossclassified,4,4,0
8114,cabinet,chair,crossclassified,4,4,0
1913,bracelet,shirt,crossclassified,4,0,4
9184,dress,sofa,crossclassified,4,4,0
490,court,woman,crossclassified,4,0,4
11443,girl,rider,crossclassified,4,4,0
9361,bucket,can,co-hyponymy,4,4,0
3364,jacket,sunglasses,crossclassified,4,4,0
2012,dugout,spectators,crossclassified,4,4,0
6531,planter,urn,crossclassified,4,4,0
1566,bridge,monorail,crossclassified,4,4,0
5075,people,snowboarder,crossclassified,4,0,4
7724,blanket,jacket,crossclassified,4,3,1
1260,eggs,pan,crossclassified,4,0,4
4330,bucket,planter,crossclassified,4,0,4
4331,plant,planter,crossclassified,4,0,4
6566,grate,motorcycle,crossclassified,4,4,0
3324,airplane,ladder,crossclassified,4,4,0
8343,crepe,food,hypernymy.2,4,0,4
7715,road,wheel,crossclassified,4,4,0
14262,bowl,spinach,crossclassified,4,4,0
2557,bread,sub,crossclassified,4,4,0
7689,grass,shirt,crossclassified,4,3,1
68,salad,veggies,crossclassified,4,4,0
7567,trough,water,crossclassified,4,4,0
3358,bench,people,crossclassified,4,4,0
5786,bridge,cars,crossclassified,4,4,0
5789,table,tent,crossclassified,4,0,4
4400,display,fruit,crossclassified,4,0,4
7733,cheese,fork,crossclassified,4,0,4
7735,airplane,pul,crossclassified,4,4,0
6345,elder,man,co-hyponymy,4,0,4
8356,counter,jug,crossclassified,4,4,0
2188,eating,man,crossclassified,4,0,4
3317,carpet,ottoman,crossclassified,4,4,0
7756,blanket,dress,crossclassified,4,2,2
2007,fries,sandwich,crossclassified,4,0,4
9542,business,restaurant,crossclassified,4,0,4
9547,short,woman,crossclassified,4,0,4
9551,timbuktu,vehicle,crossclassified,4,0,4
2008,body,dress,crossclassified,4,0,4
7736,airplane,toy,crossclassified,4,4,0
11100,blender,woman,crossclassified,4,0,4
602,male,skater,crossclassified,4,0,4
8510,cabinet,microwave,crossclassified,4,4,0
4319,bacon,hotdog,crossclassified,4,3,1
1349,apron,cape,crossclassified,4,0,4
4320,bacon,toppings,crossclassified,4,4,0
8315,plane,seaplane,hypernymy.1,4,4,0
7737,pipe,sink,crossclassified,4,0,4
14418,trolley,truck,crossclassified,4,0,4
11086,desk,shoe,crossclassified,4,4,0
67,carrot,salad,crossclassified,4,0,4
10505,fruits,table,crossclassified,4,0,4
11823,couch,desk,crossclassified,4,3,1
12347,carpet,skirt,crossclassified,4,4,0
9617,building,carriage,crossclassified,4,4,0
14798,foot,girl,crossclassified,4,0,4
12681,furniture,vase,crossclassified,4,0,4
11064,bathtub,sing,crossclassified,4,4,0
5801,leaf,pizza,crossclassified,4,0,4
14249,sail,surfer,crossclassified,4,4,0
3950,stream,water,hypernymy.2,4,0,4
6547,flower,orchid,hypernymy.1,4,4,0
11500,desk,easel,crossclassified,4,4,0
256,fence,pier,crossclassified,4,0,4
5365,bridge,horse,crossclassified,4,4,0
13040,tail,zebra,crossclassified,4,0,4
3329,bridge,britches,crossclassified,4,4,0
632,pizza,platter,crossclassified,4,4,0
7603,catcher,hat,crossclassified,4,4,0
633,scissor,shirt,crossclassified,4,0,4
3731,baby,person,hypernymy.2,4,4,0
2897,mushroom,pizza,crossclassified,4,0,4
6544,bed,pillows,crossclassified,4,4,0
3652,bathtub,washroom,crossclassified,4,4,0
2016,crowd,dugout,crossclassified,4,0,4
5356,pasta,spaghetti,hypernymy.1,4,4,0
6560,hitchhiker,woman,crossclassified,4,0,4
3354,vehicle,woman,crossclassified,4,0,4
11048,cabinets,dresser,hypernymy.1,4,0,4
7659,glass,spoon,co-hyponymy,4,3,1
9581,pan,pie,crossclassified,4,4,0
9584,man,nurse,crossclassified,4,4,0
5080,duck,geese,co-hyponymy,4,4,0
9585,dentist,man,crossclassified,4,0,4
7630,counter,handle,crossclassified,4,4,0
13045,boat,tent,crossclassified,4,4,0
4356,hotdog,sauce,crossclassified,4,3,1
4357,catsup,hotdog,crossclassified,4,0,4
7644,bathtub,wheel,crossclassified,4,4,0
7642,counter,fork,crossclassified,4,4,0
5374,couch,counter,crossclassified,4,1,3
7631,boat,motorcycle,crossclassified,4,1,3
5081,hamburger,shirt,crossclassified,4,0,4
1596,dress,train,crossclassified,4,0,4
15333,pool,wall,crossclassified,4,4,0
6348,desk,monitors,crossclassified,4,4,0
5424,cellphone,child,crossclassified,4,0,4
6509,bull,cattle,hypernymy.2,4,4,0
9423,bowl,juice,crossclassified,4,4,0
2042,food,quiche,hypernymy.1,4,4,0
1238,alcove,bench,crossclassified,4,0,4
2523,cat,t-shirt,crossclassified,4,4,0
9425,bean,vegetable,hypernymy.2,4,0,4
9426,tray,vegetable,crossclassified,4,0,4
13308,girl,skateboard,crossclassified,4,4,0
3808,kids,man,crossclassified,4,0,4
5732,cloth,rug,crossclassified,4,0,4
15417,building,ground,crossclassified,4,4,0
14275,fork,jacket,crossclassified,4,0,4
12429,chair,seats,hypernymy.2,4,4,0
13937,cinderella,doll,crossclassified,4,4,0
8326,bench,lady,crossclassified,4,4,0
7824,plate,quesadilla,crossclassified,4,0,4
9456,carpet,shoes,crossclassified,4,4,0
5831,beret,hat,crossclassified,4,0,4
3816,bowl,grapes,crossclassified,4,4,0
12416,train,wood,crossclassified,4,4,0
9420,computer,floor,crossclassified,4,0,4
570,bed,boat,crossclassified,4,1,3
3757,couch,soap,crossclassified,4,4,0
4231,pant,train,crossclassified,4,0,4
2905,boy,cup,crossclassified,4,4,0
7887,shirt,sunglasses,crossclassified,4,4,0
7878,pant,sheep,crossclassified,4,0,4
1759,car,garage,crossclassified,4,0,4
5439,dog,person,hypernymy.2,4,4,0
8320,coat,snowboarder,crossclassified,4,1,3
2800,boy,wire,crossclassified,4,4,0
255,pier,rail,crossclassified,4,4,0
8749,ramp,skating,crossclassified,4,4,0
11796,building,windows,crossclassified,4,4,0
12441,pant,plane,crossclassified,4,0,4
567,bird,hen,hypernymy.1,4,4,0
9401,cutlery,knife,hypernymy.1,4,0,4
5721,hose,house,crossclassified,4,0,4
4236,bird,macaw,hypernymy.1,4,4,0
1237,collie,dog,hypernymy.2,4,0,4
3435,garage,shop,hypernymy.2,4,4,0
14277,road,sidewalk,crossclassified,4,0,4
11798,chair,flower,crossclassified,4,4,0
7855,car,tie,crossclassified,4,4,0
14016,card,ruler,crossclassified,4,0,4
15383,booth,seat,crossclassified,4,0,4
1352,cape,cover,crossclassified,4,4,0
7550,stairs,table,crossclassified,4,0,4
5417,belt,dress,crossclassified,4,0,4
7791,geese,goose,synonymy,4,0,4
394,giraffe,neck,crossclassified,4,4,0
8335,curtain,wire,crossclassified,4,4,0
3386,shop,store,synonymy,4,0,4
14015,pocket,ruler,crossclassified,4,0,4
15334,pool,ramp,crossclassified,4,4,0
600,boy,court,crossclassified,4,4,0
2004,bench,settee,hypernymy.1,4,4,0
11028,wall,wood,crossclassified,4,4,0
11813,cabinet,chest,co-hyponymy,4,4,0
12383,cot,futon,crossclassified,4,0,4
1092,animal,woman,crossclassified,4,0,4
5761,grill,snacks,crossclassified,4,4,0
3379,animal,llama,hypernymy.1,4,0,4
11031,display,wall,crossclassified,4,3,1
3650,hiker,man,crossclassified,4,0,4
10520,statue,toy,crossclassified,4,4,0
2196,mike,woman,crossclassified,4,0,4
15709,bike,dog,crossclassified,4,4,0
7798,dress,house,crossclassified,4,0,4
1606,pant,truck,crossclassified,4,0,4
12413,bathtub,cabinet,crossclassified,4,1,3
2202,train,wooden,crossclassified,4,4,0
4271,player,teenager,crossclassified,4,4,0
9472,legs,table,crossclassified,4,0,4
915,cellphone,couch,crossclassified,4,0,4
11466,dirt,field,crossclassified,4,4,0
11125,counter,dog,crossclassified,4,4,0
9662,cupboard,sink,crossclassified,4,0,4
4409,bowl,entree,crossclassified,4,4,0
5069,desk,notebook,crossclassified,4,4,0
4279,wheel,wheelchair,crossclassified,4,0,4
15385,cake,seat,crossclassified,4,0,4
3714,band,curtain,crossclassified,4,0,4
5747,person,tent,crossclassified,4,0,4
8620,carpet,man,crossclassified,4,4,0
6320,omelet,pizza,co-hyponymy,3,0,3
433,arm,dress,crossclassified,3,0,3
6246,rug,runner,hypernymy.1,3,3,0
6319,breakfast,pizza,crossclassified,3,0,3
10729,bridge,dog,co-hyponymy,3,3,0
10726,cup,wood,crossclassified,3,3,0
13996,building,column,co-hyponymy,3,3,0
10644,pilot,train,crossclassified,3,0,3
10672,curtain,pool,crossclassified,3,3,0
8825,surfer,teen,crossclassified,3,3,0
10667,dog,doggy,hypernymy.1,3,3,0
6287,burger,fork,crossclassified,3,0,3
10701,pepsi,soda,crossclassified,3,0,3
6294,animals,cow,hypernymy.1,3,0,3
11721,counter,lateen,crossclassified,3,3,0
6362,enclosure,giraffe,crossclassified,3,0,3
6288,bun,fork,crossclassified,3,0,3
953,lake,marina,crossclassified,3,0,3
8829,boy,footballer,crossclassified,3,3,0
10653,sink,washstand,hypernymy.1,3,3,0
10655,boat,food,crossclassified,3,3,0
10697,board,cabinet,hypernymy.1,3,0,3
8543,sink,urinal,co-hyponymy,3,2,1
10691,belt,house,co-hyponymy,3,0,3
11719,scooter,wheelchair,crossclassified,3,3,0
10694,road,train,crossclassified,3,0,3
14019,gauge,ruler,crossclassified,3,0,3
8833,bathtub,pole,crossclassified,3,3,0
10679,box,cabinet,co-hyponymy,3,0,3
6256,mound,pitcher,synonymy,3,3,0
14002,airplane,ocean,crossclassified,3,3,0
11701,car,pump,crossclassified,3,3,0
11739,canopy,dugout,crossclassified,3,0,3
10718,sing,toilet,crossclassified,3,0,3
6331,couch,settee,hypernymy.1,3,3,0
6340,platter,table,crossclassified,3,0,3
6302,bug,car,crossclassified,3,0,3
12786,bowl,boy,crossclassified,3,1,2
10659,building,shoe,crossclassified,3,2,1
6369,grass,table,crossclassified,3,0,3
6368,cat,child,crossclassified,3,2,1
10646,animal,shelf,crossclassified,3,0,3
10712,desk,soundboard,crossclassified,3,3,0
8815,ban,sandwich,crossclassified,3,0,3
10735,bed,pyjamas,crossclassified,3,3,0
9061,building,business,hypernymy.2,3,3,0
6233,leg,skateboarder,crossclassified,3,2,1
11462,dirt,pant,crossclassified,3,3,0
5763,cycle,train,co-hyponymy,3,0,3
5762,bread,grill,crossclassified,3,0,3
1094,jacket,peacoat,hypernymy.1,3,3,0
11105,boots,train,crossclassified,3,0,3
11111,cat,cup,crossclassified,3,3,0
1104,floor,tiles,crossclassified,3,3,0
5748,boy,kids,hypernymy.2,3,3,0
64,dinner,salad,crossclassified,3,0,3
11121,crab,kite,crossclassified,3,0,3
11463,dirt,t-shirt,crossclassified,3,3,0
14273,bags,bench,crossclassified,3,0,3
6231,leg,skater,crossclassified,3,1,2
11139,doorway,room,crossclassified,3,3,0
11140,doorway,entrance,hypernymy.2,3,3,0
1107,boat,cycle,crossclassified,3,3,0
1111,shed,tent,crossclassified,3,0,3
5727,goat,woman,crossclassified,3,0,3
11150,chair,flowerpot,crossclassified,3,3,0
5720,house,snow,crossclassified,3,3,0
5717,cow,moose,crossclassified,3,2,1
8629,banana,house,crossclassified,3,0,3
5707,bathtub,zing,crossclassified,3,3,0
1084,boat,seat,crossclassified,3,3,0
8627,thread,woman,crossclassified,3,0,3
8624,cabinet,tray,crossclassified,3,3,0
11101,bridge,weal,crossclassified,3,3,0
11511,display,shelf,crossclassified,3,1,2
5821,coffee,table,crossclassified,3,0,3
11507,display,memorabilia,crossclassified,3,3,0
5819,light,table,crossclassified,3,0,3
11052,cap,motorcycle,crossclassified,3,0,3
5808,tent,wedding,crossclassified,3,3,0
5806,bird,finch,hypernymy.1,3,3,0
12901,cake,wheel,crossclassified,3,3,0
11497,bears,table,crossclassified,3,0,3
11487,shelf,stand,co-hyponymy,3,2,1
11080,bed,stretcher,crossclassified,3,3,0
5797,glass,pot,co-hyponymy,3,0,3
11082,bird,bookshelf,crossclassified,3,0,3
11084,bookshelf,dresser,crossclassified,3,3,0
14257,cabinet,picture,crossclassified,3,0,3
8622,headset,shirt,crossclassified,3,0,3
5779,jet,wheel,crossclassified,3,3,0
11093,counter,washstand,co-hyponymy,3,3,0
5775,rice,toy,crossclassified,3,3,0
11097,mixer,woman,crossclassified,3,0,3
11098,mix,woman,crossclassified,3,0,3
8739,airplane,skateboarder,crossclassified,3,0,3
12842,boy,dugout,crossclassified,3,0,3
5696,headboard,table,crossclassified,3,0,3
11390,curtain,goat,crossclassified,3,3,0
5594,conveyor,grill,crossclassified,3,0,3
5593,cake,grill,crossclassified,3,0,3
11375,bench,steel,crossclassified,3,3,0
11278,bun,meat,crossclassified,3,0,3
5585,electronics,jacket,crossclassified,3,0,3
11280,meat,roast,hypernymy.1,3,3,0
11296,pillow,vase,crossclassified,3,0,3
11298,bench,vase,crossclassified,3,0,3
5580,blender,machine,crossclassified,3,3,0
11360,boat,market,crossclassified,3,3,0
417,frizzle,man,crossclassified,3,0,3
8670,dish,sauce,crossclassified,3,0,3
5577,boy,snack,crossclassified,3,3,0
14339,bowl,dress,crossclassified,3,0,3
14343,desk,doll,crossclassified,3,3,0
12872,cathedral,church,hypernymy.2,3,0,3
11355,awning,giraffe,crossclassified,3,0,3
11354,giraffe,umbrella,crossclassified,3,3,0
11350,car,seat,crossclassified,3,3,0
11329,building,skyline,crossclassified,3,2,1
5548,gate,horse,crossclassified,3,0,3
5609,blender,snacks,crossclassified,3,3,0
5618,sunbather,woman,crossclassified,3,0,3
11175,plane,table,crossclassified,3,0,3
5624,counter,transmission,crossclassified,3,3,0
5676,bag,cow,co-hyponymy,3,0,3
11184,bridge,platelayer,crossclassified,3,3,0
1123,man,photo,crossclassified,3,3,0
5664,shirt,sofa,crossclassified,3,2,1
1124,wife,woman,hypernymy.2,3,0,3
5659,shirt,umbrella,crossclassified,3,3,0
11190,skater,wheel,crossclassified,3,3,0
1133,table,veggies,crossclassified,3,3,0
5651,glows,man,crossclassified,3,0,3
11191,pole,ship,crossclassified,3,0,3
5650,dress,giraffe,crossclassified,3,0,3
58,curtain,shade,crossclassified,3,3,0
8644,camera,mirror,crossclassified,3,1,2
11421,foods,fork,crossclassified,3,0,3
14313,blender,toaster,crossclassified,3,0,3
11211,beverages,bottle,crossclassified,3,0,3
416,man,trainer,crossclassified,3,3,0
8649,barrage,pizza,crossclassified,3,0,3
11228,bench,tubes,crossclassified,3,3,0
11235,bridge,meter,crossclassified,3,3,0
11237,counter,mobile,crossclassified,3,3,0
11038,apple,cat,crossclassified,3,0,3
5826,buttonhole,shirt,crossclassified,3,0,3
14241,show,woman,crossclassified,3,0,3
11659,backpack,table,crossclassified,3,0,3
6166,food,pastries,hypernymy.1,3,3,0
8566,tile,toilet,crossclassified,3,0,3
14098,curtain,suit,crossclassified,3,3,0
11653,bed,watch,crossclassified,3,3,0
10810,arena,wheel,crossclassified,3,0,3
10813,chair,cup,crossclassified,3,3,0
10817,jacket,train,crossclassified,3,0,3
10818,grass,pant,crossclassified,3,3,0
6133,glass,person,crossclassified,3,0,3
90,bathtub,dog,crossclassified,3,3,0
6107,dog,pets,crossclassified,3,3,0
10839,guy,person,hypernymy.2,3,0,3
6105,bird,prow,crossclassified,3,3,0
8807,cabinet,woman,crossclassified,3,1,2
6096,snowplow,truck,co-hyponymy,3,0,3
10844,airplane,door,crossclassified,3,3,0
6090,helmet,umpire,crossclassified,3,0,3
10848,building,nameplate,crossclassified,3,3,0
10854,boat,steel,crossclassified,3,3,0
10855,grass,pot,synonymy,3,0,3
432,building,restart,crossclassified,3,3,0
10795,flowers,grass,crossclassified,3,0,3
6174,curtain,flower,crossclassified,3,3,0
10869,sink,tie,crossclassified,3,3,0
12793,cote,jacket,crossclassified,3,0,3
10741,steel,table,crossclassified,3,0,3
6226,boy,photographer,crossclassified,3,3,0
12933,cat,scooter,crossclassified,3,0,3
14064,log,stump,crossclassified,3,0,3
10744,bench,ledge,crossclassified,3,3,0
6217,person,truck,crossclassified,3,0,3
10754,bridge,see,crossclassified,3,3,0
11676,building,entrance,crossclassified,3,3,0
10768,flowers,stand,crossclassified,3,3,0
6214,hotdog,meat,hypernymy.2,3,3,0
6212,salad,snacks,crossclassified,3,3,0
10783,helicopter,wheel,crossclassified,3,3,0
6196,library,shelf,crossclassified,3,0,3
10786,table,utensils,crossclassified,3,3,0
971,hotdog,lunch,crossclassified,3,3,0
6188,person,sweater,hypernymy.1,3,0,3
6187,cellphone,sweater,crossclassified,3,0,3
14082,canister,container,hypernymy.2,3,3,0
8813,lanyard,woman,crossclassified,3,0,3
6185,clock,dog,crossclassified,3,1,2
6177,curry,food,hypernymy.2,3,0,3
8805,batter,uniform,crossclassified,3,3,0
6056,dress,plate,crossclassified,3,3,0
11027,doll,wall,crossclassified,3,0,3
73,dirt,dugout,crossclassified,3,0,3
5942,desk,surface,crossclassified,3,3,0
10989,boat,flower,crossclassified,3,3,0
1028,bowl,breakfast,crossclassified,3,3,0
10990,boat,platform,crossclassified,3,3,0
5924,man,pedestrian,crossclassified,3,3,0
11538,cup,pitcher,co-hyponymy,3,3,0
12908,horse,shetlands,crossclassified,3,3,0
10998,railing,table,crossclassified,3,0,3
14200,dress,remote,crossclassified,3,3,0
11006,camera,laptop,crossclassified,3,3,0
8773,cabinet,capote,crossclassified,3,3,0
14206,bread,cookie,crossclassified,3,3,0
12907,child,house,crossclassified,3,0,3
5879,arm,carpet,crossclassified,3,0,3
11014,bench,building,crossclassified,3,2,1
1053,counter,placeman,crossclassified,3,3,0
11016,pants,table,crossclassified,3,0,3
5862,scooter,vesta,crossclassified,3,3,0
5856,stand,truck,crossclassified,3,0,3
1056,counter,plates,crossclassified,3,3,0
11522,cabinet,shelve,crossclassified,3,3,0
11546,boat,fruit,crossclassified,3,3,0
10967,condo,house,co-hyponymy,3,0,3
6053,booth,couch,crossclassified,3,0,3
12816,bowl,egg,crossclassified,3,3,0
8801,gown,jacket,crossclassified,3,2,1
6042,basket,table,crossclassified,3,0,3
11617,plate,shelf,crossclassified,3,0,3
8798,clothing,gown,hypernymy.1,3,0,3
14156,charger,desk,crossclassified,3,0,3
6013,court,player,crossclassified,3,3,0
14166,grill,hands,crossclassified,3,3,0
14168,jar,smoothie,crossclassified,3,3,0
12919,computer,shirt,crossclassified,3,0,3
10903,banana,shelf,crossclassified,3,3,0
10906,curtain,restroom,crossclassified,3,3,0
10919,rug,tie,crossclassified,3,3,0
5995,rug,toys,crossclassified,3,3,0
14173,flag,shirt,crossclassified,3,0,3
5990,water,zebra,crossclassified,3,0,3
8784,glider,parachute,crossclassified,3,3,0
5977,carton,juice,crossclassified,3,0,3
5975,dog,towel,crossclassified,3,3,0
402,crust,pan,crossclassified,3,3,0
10957,cabinets,door,crossclassified,3,3,0
5955,church,tower,crossclassified,3,1,2
6401,fountain,horse,crossclassified,3,0,3
841,omelette,pizza,co-hyponymy,3,0,3
11750,bed,car,crossclassified,3,1,2
9604,tie,truck,crossclassified,3,0,3
9567,cat,ground,crossclassified,3,3,0
9572,fields,horse,crossclassified,3,0,3
7687,bathtub,tile,crossclassified,3,3,0
7682,spectator,woman,crossclassified,3,0,3
13379,cake,spatula,crossclassified,3,0,3
7679,player,pole,crossclassified,3,3,0
7678,hitter,player,hypernymy.2,3,0,3
7675,bed,seat,crossclassified,3,3,0
9580,pan,tin,co-hyponymy,3,3,0
7664,eel,train,crossclassified,3,0,3
7651,ingredients,table,crossclassified,3,0,3
7640,peak,swan,crossclassified,3,0,3
9592,hose,pool,crossclassified,3,3,0
12349,banana,bench,crossclassified,3,0,3
7718,bowl,cucumber,crossclassified,3,3,0
8348,chain,jacket,crossclassified,3,0,3
9621,bowl,parfait,crossclassified,3,3,0
7621,batter,pant,crossclassified,3,3,0
13408,cot,man,crossclassified,3,0,3
257,boardwalk,pier,crossclassified,3,0,3
13041,butt,zebra,crossclassified,3,0,3
9642,house,store,crossclassified,3,3,0
7584,shirt,snow,crossclassified,3,0,3
15749,building,gazebo,hypernymy.1,3,3,0
7579,sauce,toppings,crossclassified,3,3,0
7577,child,pitcher,crossclassified,3,0,3
7576,jacket,pitcher,crossclassified,3,0,3
7575,pitcher,woman,crossclassified,3,3,0
15797,broccoli,leek,crossclassified,3,0,3
13355,lamb,toy,crossclassified,3,0,3
13536,cloth,elephant,crossclassified,3,0,3
593,dinner,pizza,crossclassified,3,0,3
9464,shower,tub,crossclassified,3,3,0
276,broccoli,lettuce,crossclassified,3,0,3
9474,cup,mixer,crossclassified,3,3,0
9475,cup,fruit,crossclassified,3,3,0
12404,carpet,clothes,crossclassified,3,3,0
7810,hands,table,crossclassified,3,0,3
9485,skateboarder,skateboarding,crossclassified,3,3,0
7807,cooking,woman,crossclassified,3,0,3
9490,counter,toilet,crossclassified,3,3,0
7797,couch,monitor,crossclassified,3,3,0
592,building,signal,crossclassified,3,3,0
12401,hat,van,crossclassified,3,0,3
9516,beverage,mug,crossclassified,3,0,3
7786,dog,shepherd,crossclassified,3,3,0
7731,maid,woman,hypernymy.2,3,0,3
7781,bridge,roof,crossclassified,3,3,0
13328,giraffe,skydiving,crossclassified,3,3,0
9532,flower,tulip,crossclassified,3,3,0
8339,light,plane,crossclassified,3,0,3
7767,desk,display,crossclassified,3,3,0
13338,bird,flower,crossclassified,3,3,0
13340,pavilion,roof,crossclassified,3,0,3
13341,roof,zebra,crossclassified,3,3,0
7758,blanket,clothes,crossclassified,3,3,0
12371,carpet,flower,crossclassified,3,3,0
9563,fields,zebra,crossclassified,3,0,3
7750,tent,wheel,crossclassified,3,3,0
8995,flower,train,crossclassified,3,0,3
12330,furniture,stand,hypernymy.1,3,0,3
7574,pant,pitcher,crossclassified,3,0,3
9647,child,sofa,crossclassified,3,3,0
13508,berries,bowl,crossclassified,3,0,3
7437,menu,table,co-hyponymy,3,0,3
12294,boots,table,crossclassified,3,0,3
7430,cutlery,fork,hypernymy.1,3,0,3
8982,airplane,pole,crossclassified,3,3,0
7426,basket,counter,crossclassified,3,0,3
9733,sweater,tie,crossclassified,3,3,0
9735,glass,mug,co-hyponymy,3,1,2
7414,bowl,dip,crossclassified,3,3,0
7412,crown,hat,crossclassified,3,0,3
13504,dresser,truck,crossclassified,3,0,3
12689,countertop,pizza,crossclassified,3,0,3
13507,blackberries,bowl,crossclassified,3,0,3
9746,boat,child,crossclassified,3,3,0
7390,elephant,shelter,crossclassified,3,3,0
13436,highchair,plate,crossclassified,3,3,0
12280,chair,clock,crossclassified,3,1,2
7382,food,fries,hypernymy.1,3,3,0
7380,cabinet,curtain,crossclassified,3,3,0
689,cow,head,crossclassified,3,3,0
12279,cat,motorcycle,crossclassified,3,0,3
9760,pasture,sheep,crossclassified,3,0,3
9762,arm,coat,crossclassified,3,0,3
13527,tie,watch,crossclassified,3,3,0
7361,hat,snowboarder,crossclassified,3,0,3
7359,jacket,women,crossclassified,3,3,0
464,poncho,woman,crossclassified,3,3,0
240,child,umbrella,crossclassified,3,3,0
7346,house,skating,crossclassified,3,3,0
7445,raincoat,shirt,crossclassified,3,0,3
9726,car,giraffe,crossclassified,3,0,3
13483,salad,snakes,crossclassified,3,3,0
7476,handle,knife,crossclassified,3,0,3
7557,shirt,wall,crossclassified,3,2,1
9648,bellow,cat,crossclassified,3,0,3
9654,cow,deer,crossclassified,3,3,0
7551,jars,table,crossclassified,3,0,3
7547,man,pillow,crossclassified,3,3,0
9668,cat,cupboard,crossclassified,3,3,0
7546,pot,shirt,crossclassified,3,0,3
7545,bowl,shirt,crossclassified,3,1,2
9670,breakfast,sandwich,crossclassified,3,0,3
7536,door,wood,crossclassified,3,3,0
7534,door,table,crossclassified,3,3,0
12320,boat,cart,crossclassified,3,3,0
7526,horse,train,crossclassified,3,3,0
13449,boy,cabinet,crossclassified,3,0,3
8986,animal,building,crossclassified,3,0,3
13033,jersey,pitcher,crossclassified,3,0,3
7519,airplane,earphone,crossclassified,3,3,0
7516,bowl,cheese,crossclassified,3,3,0
9683,curtain,tarp,crossclassified,3,3,0
9694,elephant,fence,crossclassified,3,3,0
657,tub,washbasin,crossclassified,3,3,0
13458,trailer,wheel,co-hyponymy,3,3,0
7497,bench,stick,crossclassified,3,3,0
9707,toilet,water,crossclassified,3,3,0
7489,barrier,bridge,crossclassified,3,0,3
7487,curtains,lamp,crossclassified,3,1,2
9708,awning,light,crossclassified,3,3,0
9463,bath,shower,co-hyponymy,3,0,3
9462,screen,shower,crossclassified,3,0,3
13313,fish,plate,crossclassified,3,3,0
9191,building,wood,crossclassified,3,3,0
13152,guacamole,smoothie,crossclassified,3,3,0
8141,legs,man,crossclassified,3,1,2
485,cow,heifer,hypernymy.1,3,3,0
8128,fountain,toilet,co-hyponymy,3,0,3
9172,bad,dog,crossclassified,3,0,3
9176,bottle,shelf,crossclassified,3,1,2
8109,fries,pizza,crossclassified,3,0,3
9185,blender,jug,crossclassified,3,3,0
5545,house,picture,crossclassified,3,3,0
13173,pitcher,water,crossclassified,3,3,0
8093,fan,vent,crossclassified,3,0,3
351,head,sheep,crossclassified,3,0,3
8090,bedcover,carpet,crossclassified,3,0,3
8085,bedspread,carpet,crossclassified,3,0,3
12539,chair,computer,crossclassified,3,3,0
8083,cheese,pan,crossclassified,3,0,3
12566,dresser,toy,crossclassified,3,3,0
8079,cheese,man,crossclassified,3,0,3
8078,cage,giraffe,crossclassified,3,0,3
307,female,surfer,crossclassified,3,0,3
9200,clothing,kimono,hypernymy.1,3,0,3
8072,cabbage,veg,hypernymy.2,3,3,0
9222,doghouse,outhouse,co-hyponymy,3,0,3
9229,leash,tie,crossclassified,3,0,3
9234,bottle,soap,crossclassified,3,3,0
8053,butterfly,orange,crossclassified,3,3,0
13201,skiers,woman,crossclassified,3,0,3
8044,pan,toast,crossclassified,3,3,0
8150,photo,shirt,crossclassified,3,0,3
8152,bedcover,couch,crossclassified,3,0,3
483,cow,ram,crossclassified,3,2,1
12591,bag,seat,crossclassified,3,0,3
9062,bun,cheese,crossclassified,3,2,1
9060,laptop,person,crossclassified,3,3,0
9071,rope,woman,crossclassified,3,0,3
8241,crane,truck,crossclassified,3,0,3
12645,bed,tie,crossclassified,3,3,0
12634,couch,pizza,crossclassified,3,3,0
12632,curtain,pant,crossclassified,3,3,0
8226,burrito,taco,co-hyponymy,3,0,3
12631,carpet,pizza,crossclassified,3,3,0
13112,dugout,people,crossclassified,3,3,0
9094,shelf,toothbrush,crossclassified,3,0,3
12627,screen,wall,co-hyponymy,3,0,3
9098,bench,bowl,crossclassified,3,3,0
8208,barer,sandwich,crossclassified,3,0,3
9099,bench,pot,crossclassified,3,3,0
8199,cap,dog,crossclassified,3,0,3
12624,microwave,t-shirt,crossclassified,3,3,0
9052,toy,wall,crossclassified,3,1,2
9114,bicyclist,shirt,crossclassified,3,0,3
8186,sky,wing,crossclassified,3,0,3
9122,flower,orchids,hypernymy.1,3,3,0
8252,handle,table,crossclassified,3,0,3
8174,doll,rug,crossclassified,3,0,3
9049,head,toy,crossclassified,3,0,3
9137,building,game,crossclassified,3,0,3
8160,cup,dessert,crossclassified,3,3,0
9045,drink,woman,crossclassified,3,0,3
8275,hoagie,hotdog,co-hyponymy,3,0,3
15791,food,leek,hypernymy.1,3,0,3
12426,couch,fabric,crossclassified,3,3,0
7868,ball,person,crossclassified,3,0,3
13063,rice,salad,crossclassified,3,2,1
7919,counter,dishes,crossclassified,3,3,0
12478,counter,vegetable,crossclassified,3,3,0
12473,board,truck,crossclassified,3,0,3
12468,counter,donut,crossclassified,3,3,0
7893,building,gate,crossclassified,3,3,0
9372,bread,snakes,crossclassified,3,3,0
7889,bridge,skate,crossclassified,3,3,0
9379,suit,truck,crossclassified,3,0,3
8999,cupboard,table,crossclassified,3,0,3
9395,countertop,stove,crossclassified,3,0,3
7873,carpet,feet,crossclassified,3,3,0
13294,bookshelf,ear,crossclassified,3,3,0
8322,dress,necklace,crossclassified,3,3,0
9254,omelet,soup,co-hyponymy,3,0,3
9408,athlete,skateboarder,hypernymy.1,3,0,3
7857,hood,light,crossclassified,3,3,0
9409,eating,jacket,crossclassified,3,0,3
7851,robe,t-shirt,crossclassified,3,3,0
9422,bowl,drink,crossclassified,3,3,0
12680,drawer,vase,crossclassified,3,0,3
7835,airplane,mountain,crossclassified,3,3,0
8323,bench,cheese,crossclassified,3,3,0
7833,airings,man,crossclassified,3,0,3
8325,bench,cup,crossclassified,3,3,0
9436,man,sects,crossclassified,3,3,0
582,bookcase,desk,crossclassified,3,0,3
13310,fish,lemon,crossclassified,3,3,0
13267,cheetah,leopard,co-hyponymy,3,3,0
288,duck,duckling,hypernymy.1,3,3,0
289,dove,duck,co-hyponymy,3,0,3
12666,countertop,food,crossclassified,3,0,3
8280,bookshelf,t-shirt,crossclassified,3,3,0
9255,frittata,soup,co-hyponymy,3,0,3
8006,counter,flower,crossclassified,3,3,0
8284,boy,skate,crossclassified,3,3,0
13229,man,seat,crossclassified,3,3,0
13233,boy,rider,crossclassified,3,3,0
9273,cabinet,keyboard,crossclassified,3,3,0
9274,cow,gate,crossclassified,3,3,0
7986,fork,girl,crossclassified,3,0,3
525,airline,plane,crossclassified,3,0,3
529,dresser,shelf,crossclassified,3,3,0
7977,kite,man,crossclassified,3,0,3
7975,shirt,towel,crossclassified,3,3,0
9277,bag,bookshelf,crossclassified,3,0,3
9280,nurse,person,hypernymy.2,3,3,0
13240,shoes,woman,crossclassified,3,0,3
9292,bed,men,crossclassified,3,3,0
9018,floor,luggage,crossclassified,3,3,0
536,headphone,shirt,crossclassified,3,0,3
9306,counter,drawers,crossclassified,3,3,0
7943,cake,vase,crossclassified,3,1,2
15771,clock,railing,crossclassified,3,3,0
9318,bike,carpet,crossclassified,3,0,3
9332,duck,statue,crossclassified,3,3,0
12490,counter,sing,crossclassified,3,3,0
9336,floor,picture,crossclassified,3,3,0
7927,motorcycle,table,crossclassified,3,3,0
7345,garment,jacket,hypernymy.1,3,0,3
8377,box,shirt,crossclassified,3,0,3
6406,restaurant,sign,crossclassified,3,3,0
8486,boat,rope,crossclassified,3,3,0
13836,clock,couch,crossclassified,3,3,0
6741,scoreboard,t-shirt,crossclassified,3,3,0
10324,building,grill,hypernymy.1,3,3,0
6736,scoreboard,shirt,crossclassified,3,3,0
6730,plate,toast,crossclassified,3,2,1
13842,cupcakes,plate,crossclassified,3,3,0
6722,bowl,pie,crossclassified,3,3,0
11909,floor,wire,crossclassified,3,3,0
6709,desk,mess,crossclassified,3,3,0
6692,dugout,pole,crossclassified,3,3,0
10358,dress,tattoo,crossclassified,3,3,0
8476,dog,pole,crossclassified,3,3,0
11902,lorry,train,crossclassified,3,0,3
6673,bowl,cow,crossclassified,3,0,3
10321,doll,horse,crossclassified,3,0,3
8492,bed,grill,crossclassified,3,3,0
6666,carpet,cloth,crossclassified,3,3,0
10384,banana,spoon,crossclassified,3,0,3
11889,awning,storefront,crossclassified,3,2,1
889,man,swimmer,crossclassified,3,3,0
11885,shop,storefront,crossclassified,3,0,3
10407,airplane,bag,crossclassified,3,3,0
13872,drink,tea,hypernymy.1,3,0,3
6661,airplane,steel,crossclassified,3,3,0
11877,plane,tail,crossclassified,3,3,0
6658,bed,ladder,crossclassified,3,3,0
6649,child,gown,crossclassified,3,3,0
6648,broccoli,knife,crossclassified,3,0,3
6745,coat,skater,crossclassified,3,0,3
10315,chairs,woman,crossclassified,3,0,3
13538,canopy,elephant,crossclassified,3,0,3
13787,pizza,rug,crossclassified,3,0,3
13754,benches,table,hypernymy.2,3,3,0
8919,lasagna,pizza,crossclassified,3,0,3
10205,burger,chair,crossclassified,3,0,3
10206,chair,food,crossclassified,3,3,0
12003,couch,lamp,crossclassified,3,3,0
10214,comb,shirt,crossclassified,3,0,3
6872,cabin,hut,crossclassified,3,0,3
13765,bowl,curtain,crossclassified,3,0,3
10239,book,rug,crossclassified,3,0,3
11986,lamppost,tent,crossclassified,3,0,3
6845,man,sports,co-hyponymy,3,3,0
867,cabinet,electronics,crossclassified,3,3,0
6833,sign,truck,crossclassified,3,0,3
6821,robe,toga,crossclassified,3,0,3
13830,bench,sheer,crossclassified,3,3,0
11976,floor,skate,crossclassified,3,3,0
443,carpet,lamp,crossclassified,3,3,0
6812,catcher,male,crossclassified,3,3,0
11972,airplane,monoplane,hypernymy.1,3,3,0
11959,chair,seating,crossclassified,3,3,0
12980,meat,rice,crossclassified,3,0,3
10281,giraffe,house,crossclassified,3,1,2
13810,dock,house,crossclassified,3,3,0
185,donut,glaze,crossclassified,3,3,0
6772,doll,fish,crossclassified,3,0,3
8472,cabinet,wire,crossclassified,3,3,0
13824,bush,car,crossclassified,3,0,3
10308,board,pant,crossclassified,3,3,0
10439,window,windshield,crossclassified,3,0,3
13876,boy,water,crossclassified,3,3,0
10442,man,mick,crossclassified,3,3,0
137,curtain,robe,crossclassified,3,0,3
12957,boy,wheel,crossclassified,3,3,0
6513,bowl,toy,crossclassified,3,3,0
8880,blanket,towel,crossclassified,3,3,0
13940,cinderella,dress,crossclassified,3,3,0
6506,bull,cowboy,crossclassified,3,3,0
917,couch,mobile,crossclassified,3,3,0
13945,bottle,curtain,crossclassified,3,0,3
13949,band,woman,crossclassified,3,0,3
13954,salad,veritable,crossclassified,3,3,0
10559,men,table,crossclassified,3,0,3
8866,electronics,laptop,crossclassified,3,0,3
395,crust,tray,crossclassified,3,3,0
8859,hydroplane,plane,hypernymy.2,3,0,3
135,pillar,train,crossclassified,3,0,3
6638,food,lemon,hypernymy.1,3,2,1
10591,bird,see,crossclassified,3,3,0
10595,glass,kettle,co-hyponymy,3,0,3
12766,doll,train,crossclassified,3,0,3
10600,food,kettle,crossclassified,3,0,3
13967,slipper,woman,crossclassified,3,0,3
13970,man,parrot,crossclassified,3,3,0
10603,blender,kettle,crossclassified,3,0,3
6443,handlebars,motorcycle,crossclassified,3,0,3
10611,fire,table,crossclassified,3,0,3
6419,box,salad,crossclassified,3,0,3
10617,cart,table,crossclassified,3,0,3
11757,armor,wardrobe,crossclassified,3,0,3
111,curtain,flag,crossclassified,3,3,0
10532,dog,kitten,crossclassified,3,1,2
13934,cinderella,toy,crossclassified,3,3,0
6525,bowl,hotdog,crossclassified,3,1,2
6527,dexter,man,crossclassified,3,0,3
6635,grapefruit,lemon,co-hyponymy,3,0,3
6634,bird,giraffe,crossclassified,3,0,3
13886,mouth,zebra,crossclassified,3,0,3
8502,dog,face,crossclassified,3,3,0
8892,boy,eyeglass,crossclassified,3,3,0
6625,cow,pant,crossclassified,3,3,0
8890,blanket,person,crossclassified,3,3,0
6620,hair,jacket,crossclassified,3,0,3
10463,blanket,jeans,crossclassified,3,3,0
6593,bench,stand,crossclassified,3,3,0
10489,building,buildings,synonymy,3,3,0
11834,counter,sweet,crossclassified,3,3,0
11830,truck,trucker,crossclassified,3,3,0
6571,relish,toppings,crossclassified,3,3,0
6569,hotdog,relish,crossclassified,3,0,3
10498,kerchief,woman,crossclassified,3,0,3
903,bread,muffin,hypernymy.1,3,2,1
6557,bed,light,crossclassified,3,3,0
10511,jacket,pen,crossclassified,3,3,0
11817,building,horse,crossclassified,3,3,0
6542,boy,glasses,crossclassified,3,3,0
8509,cabinet,jug,crossclassified,3,3,0
10515,desk,flower,crossclassified,3,3,0
907,hydrant,lid,crossclassified,3,3,0
11816,building,rope,crossclassified,3,3,0
10517,cycle,statue,crossclassified,3,0,3
6530,cow,longhorn,crossclassified,3,3,0
6887,cheese,donut,crossclassified,3,0,3
6888,ring,table,crossclassified,3,0,3
10184,bull,oxen,hypernymy.2,3,3,0
7178,bowl,sink,crossclassified,3,1,2
7242,animal,doll,crossclassified,3,3,0
13596,boy,bun,crossclassified,3,3,0
7217,dish,tray,crossclassified,3,3,0
9849,food,hole,crossclassified,3,3,0
9853,chair,truck,crossclassified,3,0,3
7213,cat,ear,crossclassified,3,3,0
7212,cat,head,crossclassified,3,3,0
12207,car,furniture,crossclassified,3,0,3
13604,room,window,crossclassified,3,0,3
12201,bike,desk,crossclassified,3,0,3
463,person,poncho,crossclassified,3,0,3
12198,cycle,desk,crossclassified,3,0,3
7179,cup,sink,crossclassified,3,0,3
8384,bridge,grill,crossclassified,3,3,0
12173,suv,wheel,crossclassified,3,3,0
7170,boy,juice,crossclassified,3,3,0
7168,jacket,wire,crossclassified,3,3,0
8389,jacket,leg,crossclassified,3,3,0
9910,coleslaw,slaw,synonymy,3,3,0
12691,bed,counter,crossclassified,3,3,0
9918,cookie,snack,crossclassified,3,3,0
8406,couch,lounge,synonymy,3,3,0
8407,couch,daybed,hypernymy.1,3,3,0
9925,bred,table,crossclassified,3,0,3
12182,lattice,table,crossclassified,3,0,3
9943,railroad,tracks,hypernymy.2,3,0,3
7150,bench,children,crossclassified,3,3,0
9946,belt,girl,crossclassified,3,0,3
9843,cake,gift,crossclassified,3,3,0
13585,moped,wheel,crossclassified,3,3,0
13584,dog,girl,crossclassified,3,1,2
7250,girl,wheel,crossclassified,3,3,0
7339,child,fence,crossclassified,3,0,3
9795,breakfast,cereal,crossclassified,3,0,3
7332,glasses,wine,crossclassified,3,3,0
7328,console,desk,co-hyponymy,3,0,3
7321,counter,tissue,crossclassified,3,3,0
12251,chair,leg,crossclassified,3,3,0
7309,canopy,tarp,crossclassified,3,3,0
9811,counter,television,crossclassified,3,3,0
7304,boy,gloves,crossclassified,3,3,0
9813,plane,turboprop,hypernymy.1,3,3,0
9814,can,vase,crossclassified,3,0,3
7299,computers,desk,crossclassified,3,0,3
9820,cake,flower,crossclassified,3,3,0
12244,floor,photo,crossclassified,3,3,0
7288,skateboarder,tent,crossclassified,3,0,3
13563,brush,cup,crossclassified,3,0,3
9826,ground,path,crossclassified,3,3,0
7276,rider,skateboarder,crossclassified,3,0,3
9827,ground,walkway,crossclassified,3,3,0
7272,food,wok,crossclassified,3,0,3
9828,ground,lawn,crossclassified,3,3,0
7265,bed,wire,crossclassified,3,3,0
13575,apple,melon,co-hyponymy,3,0,3
9837,board,train,crossclassified,3,0,3
13576,spoon,vegetable,crossclassified,3,3,0
7257,bowl,toys,crossclassified,3,3,0
752,rank,truck,crossclassified,3,0,3
7130,hotdog,vegetable,crossclassified,3,3,0
778,cockpit,plane,crossclassified,3,0,3
8920,dog,grass,crossclassified,3,3,0
6958,onion,salad,crossclassified,3,0,3
8446,counter,tub,crossclassified,3,3,0
13698,carrot,girl,crossclassified,3,0,3
13703,man,tree,crossclassified,3,3,0
6981,bench,steps,crossclassified,3,3,0
12085,file,table,crossclassified,3,0,3
10087,backpack,bed,crossclassified,3,0,3
12991,skier,snowboard,crossclassified,3,3,0
10090,class,shirt,crossclassified,3,0,3
10105,chide,man,crossclassified,3,0,3
825,cat,collar,crossclassified,3,3,0
6963,counter,drinks,crossclassified,3,3,0
10114,car,crosswalk,crossclassified,3,3,0
6959,animal,elephant,hypernymy.1,3,0,3
10121,hutch,mirror,crossclassified,3,0,3
13641,bread,tortilla,crossclassified,3,0,3
10127,mirror,table,crossclassified,3,1,2
12726,shower,wall,crossclassified,3,3,0
6943,mirror,street,crossclassified,3,0,3
6937,asian,man,crossclassified,3,0,3
6932,apple,donut,crossclassified,3,1,2
10140,dugout,hut,co-hyponymy,3,3,0
8457,cub,woman,crossclassified,3,0,3
12046,car,player,crossclassified,3,3,0
8461,curtain,lateen,crossclassified,3,3,0
6913,plate,platter,co-hyponymy,3,3,0
13745,hood,t-shirt,crossclassified,3,3,0
6904,tree,window,crossclassified,3,0,3
13747,boy,hood,crossclassified,3,0,3
12094,holder,table,crossclassified,3,0,3
12721,building,electronics,crossclassified,3,3,0
10062,dog,sand,crossclassified,3,3,0
10058,carpet,grass,crossclassified,3,3,0
7118,shirt,smock,crossclassified,3,3,0
7111,couch,mug,crossclassified,3,3,0
9960,engine,propeller,crossclassified,3,0,3
12700,jogger,man,crossclassified,3,0,3
13663,meat,plate,hypernymy.1,3,3,0
9971,banana,desk,crossclassified,3,0,3
7081,coat,gown,crossclassified,3,1,2
8412,bin,bucket,co-hyponymy,3,0,3
8414,bucket,wine,crossclassified,3,3,0
7075,arrangement,flower,crossclassified,3,0,3
381,burger,girl,crossclassified,3,0,3
12142,highchair,seat,hypernymy.2,3,3,0
12135,motorcycle,wheels,crossclassified,3,3,0
10004,bed,clothe,crossclassified,3,3,0
10005,fields,sheep,crossclassified,3,0,3
8955,bed,curtains,crossclassified,3,3,0
10013,hatchback,trunk,crossclassified,3,0,3
10016,hatch,trunk,crossclassified,3,0,3
7048,carpet,mattress,crossclassified,3,3,0
8428,ballplayer,boy,crossclassified,3,0,3
12124,bike,plane,crossclassified,3,0,3
7027,building,table,co-hyponymy,3,2,1
10044,person,statue,crossclassified,3,0,3
7023,fruits,truck,crossclassified,3,0,3
12105,bed,mobile,crossclassified,3,3,0
12992,reuben,sandwich,hypernymy.2,3,0,3
7016,dugout,net,crossclassified,3,3,0
845,grandmother,woman,crossclassified,3,0,3
11336,man,scissors,crossclassified,3,3,0
4486,glasses,shirt,crossclassified,3,0,3
3975,boat,logs,crossclassified,3,3,0
1754,hotdog,sauerkraut,crossclassified,3,3,0
3981,bottle,refrigerator,crossclassified,3,0,3
1750,gravy,soup,crossclassified,3,2,1
5085,floor,legs,crossclassified,3,3,0
2661,food,snakes,crossclassified,3,3,0
3996,boy,women,crossclassified,3,3,0
15466,bench,duck,crossclassified,3,3,0
3218,model,plane,crossclassified,3,0,3
4002,boy,train,crossclassified,3,3,0
5076,snowboarder,socket,crossclassified,3,3,0
4004,batter,guy,crossclassified,3,3,0
3217,monoplane,plane,hypernymy.2,3,0,3
2669,ballplayer,desk,crossclassified,3,0,3
5072,boy,cab,crossclassified,3,3,0
3215,carpet,mobile,crossclassified,3,3,0
1351,cape,smock,crossclassified,3,3,0
2075,diners,man,crossclassified,3,0,3
15298,train,triennial,crossclassified,3,3,0
15155,rider,tent,crossclassified,3,0,3
2318,bridge,rails,crossclassified,3,3,0
5099,child,cup,crossclassified,3,3,0
2061,cucumber,vegetable,hypernymy.2,3,3,0
5143,bike,ship,crossclassified,3,0,3
5142,motorbike,ship,crossclassified,3,0,3
5141,eating,woman,crossclassified,3,0,3
5139,bench,plank,crossclassified,3,3,0
3934,skater,surfer,crossclassified,3,0,3
5138,bench,roof,crossclassified,3,3,0
1765,caller,man,crossclassified,3,0,3
3943,fruit,platter,crossclassified,3,3,0
5123,desk,sweater,crossclassified,3,3,0
2331,boat,light,crossclassified,3,3,0
3956,bridge,platform,hypernymy.2,3,3,0
5117,grass,man,crossclassified,3,0,3
3957,plane,sky,crossclassified,3,3,0
5105,salad,toppings,crossclassified,3,3,0
5104,cow,fence,crossclassified,3,3,0
14534,ambulance,car,hypernymy.2,3,3,0
3208,boy,carpet,crossclassified,3,1,2
5060,girl,glasses,crossclassified,3,3,0
5324,bulgur,sandwich,crossclassified,3,0,3
14893,elephant,mask,crossclassified,3,3,0
2307,airport,planes,crossclassified,3,3,0
14892,elephant,headdress,crossclassified,3,3,0
2700,motorcycle,tricycle,crossclassified,3,3,0
4090,hat,phone,crossclassified,3,3,0
15175,all,toy,crossclassified,3,0,3
4096,cupcake,wrapper,crossclassified,3,0,3
4099,bookcase,table,co-hyponymy,3,0,3
2703,man,window,crossclassified,3,2,1
4106,pizza,vegetable,crossclassified,3,3,0
2301,chair,cover,crossclassified,3,3,0
3173,bed,pizza,crossclassified,3,3,0
4995,catcher,pitcher,co-hyponymy,3,2,1
4121,drinker,woman,crossclassified,3,0,3
4991,car,zebra,crossclassified,3,3,0
2082,cloakroom,dugout,crossclassified,3,0,3
15178,fur,toy,crossclassified,3,0,3
1695,bridge,lake,crossclassified,3,3,0
5021,rusher,woman,crossclassified,3,0,3
5023,sandwich,vegetables,crossclassified,3,3,0
5056,bartender,man,crossclassified,3,0,3
4077,store,truck,crossclassified,3,0,3
2317,bridge,steel,crossclassified,3,3,0
2076,booth,man,crossclassified,3,2,1
4029,cow,woman,crossclassified,3,3,0
2316,bridge,pant,crossclassified,3,3,0
4033,tablecloth,wall,crossclassified,3,3,0
2679,mirror,van,crossclassified,3,0,3
14912,candle,chair,crossclassified,3,0,3
14554,cup,pail,co-hyponymy,3,3,0
14908,shirt,wine,crossclassified,3,3,0
4048,dog,labrador,crossclassified,3,3,0
2690,leaf,lettuce,crossclassified,3,0,3
3193,floor,wall,crossclassified,3,2,1
1357,cape,shirt,crossclassified,3,1,2
2691,lettuce,plant,hypernymy.2,3,3,0
15628,plants,rug,crossclassified,3,0,3
5025,water,woman,crossclassified,3,0,3
2692,kale,lettuce,synonymy,3,0,3
3272,sandwich,taco,crossclassified,3,3,0
14512,donut,kerchief,crossclassified,3,3,0
5162,building,scissors,crossclassified,3,3,0
2555,skateboard,tent,crossclassified,3,0,3
14465,clock,roof,crossclassified,3,3,0
2558,hat,tie,crossclassified,3,3,0
1834,man,toothbrush,crossclassified,3,3,0
5255,counter,rug,crossclassified,3,0,3
3786,boy,floor,crossclassified,3,2,1
3352,cake,couch,crossclassified,3,0,3
2367,car,handle,crossclassified,3,3,0
3792,dress,floor,crossclassified,3,0,3
14997,land,shore,crossclassified,3,0,3
3347,bratwurst,hotdog,crossclassified,3,0,3
3346,chair,hotdog,crossclassified,3,2,1
5245,beer,man,crossclassified,3,0,3
5242,counter,stool,crossclassified,3,3,0
3810,chair,pizza,crossclassified,3,2,1
2365,scoop,spatula,crossclassified,3,0,3
2571,carpet,tripod,crossclassified,3,3,0
2572,carpet,stand,crossclassified,3,3,0
5266,cake,slice,crossclassified,3,3,0
5268,girl,scissors,crossclassified,3,3,0
5165,carrot,truck,crossclassified,3,0,3
15002,lake,shore,crossclassified,3,0,3
3736,bathtub,wash,crossclassified,3,3,0
3739,man,vehicle,crossclassified,3,3,0
3741,jacket,sofa,crossclassified,3,3,0
5320,jacket,men,crossclassified,3,3,0
5318,counter,fish,co-hyponymy,3,3,0
3385,business,store,crossclassified,3,0,3
3751,chair,wheel,crossclassified,3,3,0
15119,blanket,drape,crossclassified,3,3,0
3755,pizza,toast,crossclassified,3,3,0
2385,desk,shelves,crossclassified,3,3,0
1301,bed,cart,crossclassified,3,3,0
5289,controller,desk,crossclassified,3,0,3
15007,beach,shore,co-hyponymy,3,0,3
5284,balcony,building,co-hyponymy,3,0,3
3771,filling,sandwich,crossclassified,3,0,3
2544,booth,shirt,crossclassified,3,2,1
1310,desk,headset,crossclassified,3,3,0
3824,clothes,suit,crossclassified,3,0,3
3827,table,tea,crossclassified,3,3,0
5227,sandwich,woman,crossclassified,3,0,3
5225,boy,elephant,crossclassified,3,3,0
3875,advertisement,pizza,crossclassified,3,0,3
15318,hand,mobile,crossclassified,3,3,0
5200,gourd,squash,co-hyponymy,3,0,3
3882,art,cake,crossclassified,3,0,3
3302,cup,smoothie,crossclassified,3,3,0
14494,tress,woman,crossclassified,3,0,3
3888,biscuit,cookie,synonymy,3,1,2
5188,hamster,rat,co-hyponymy,3,3,0
5186,cup,drinks,hypernymy.2,3,3,0
5182,hand,woman,crossclassified,3,0,3
3891,biscuit,pastry,crossclassified,3,3,0
2341,dog,laptop,crossclassified,3,3,0
3897,cart,luggage,crossclassified,3,3,0
14503,man,snakes,crossclassified,3,3,0
2624,apron,van,crossclassified,3,0,3
3289,clothing,hat,hypernymy.1,3,0,3
1325,playing,woman,crossclassified,3,0,3
3874,pizza,sign,crossclassified,3,2,1
3873,bear,desk,crossclassified,3,0,3
2599,shirt,tunic,crossclassified,3,3,0
3837,bird,myna,hypernymy.1,3,3,0
2359,couch,room,crossclassified,3,3,0
3828,skater,women,crossclassified,3,3,0
2580,grill,tomato,crossclassified,3,3,0
14988,child,tub,crossclassified,3,0,3
3341,bra,woman,crossclassified,3,0,3
15326,child,skate,crossclassified,3,3,0
1805,house,steel,crossclassified,3,3,0
5217,child,counter,co-hyponymy,3,0,3
1798,cargo,truck,crossclassified,3,0,3
3334,cabin,restaurant,crossclassified,3,0,3
2032,bowl,spaghetti,crossclassified,3,3,0
3852,house,people,co-hyponymy,3,3,0
3325,rug,tiles,crossclassified,3,3,0
2038,airplane,floor,crossclassified,3,2,1
3863,desk,legs,crossclassified,3,3,0
15394,bike,wall,crossclassified,3,0,3
4136,face,hat,crossclassified,3,0,3
2086,motorcycle,vesta,crossclassified,3,3,0
4968,chair,sweater,crossclassified,3,3,0
4438,athlete,child,crossclassified,3,0,3
2133,fabric,umbrella,crossclassified,3,0,3
4448,cab,truck,crossclassified,3,0,3
2863,couch,ottoman,co-hyponymy,3,0,3
4457,man,visitor,crossclassified,3,3,0
4458,auto,car,synonymy,3,0,3
4746,machine,train,crossclassified,3,0,3
4745,pillow,window,crossclassified,3,0,3
3008,bottle,liquor,crossclassified,3,3,0
4736,cage,dugout,crossclassified,3,0,3
4735,dugout,stage,crossclassified,3,3,0
15252,boy,tress,crossclassified,3,3,0
3007,bag,motorcycle,crossclassified,3,0,3
4468,automobile,shirt,crossclassified,3,0,3
14757,belt,carpet,crossclassified,3,0,3
15223,building,cabana,crossclassified,3,3,0
2999,plate,robe,crossclassified,3,0,3
2996,door,entryway,hypernymy.2,3,3,0
4445,person,skateboard,crossclassified,3,1,2
4761,pole,stoplight,crossclassified,3,3,0
3035,snowboard,surfer,crossclassified,3,0,3
4762,light,pole,crossclassified,3,1,2
3029,automobile,bus,hypernymy.1,3,0,3
4797,bridge,tram,crossclassified,3,3,0
4795,bridge,subway,crossclassified,3,3,0
14780,canopy,window,crossclassified,3,0,3
4412,table,wineglass,crossclassified,3,3,0
14653,bridge,skater,crossclassified,3,3,0
4414,beverages,table,crossclassified,3,0,3
4782,emu,ostrich,co-hyponymy,3,0,3
14775,bike,window,crossclassified,3,0,3
3020,clothing,table,crossclassified,3,0,3
4423,toilet,woman,crossclassified,3,0,3
4773,strap,woman,crossclassified,3,0,3
1560,elephant,mirror,crossclassified,3,0,3
14661,banana,sandwich,crossclassified,3,3,0
4766,picture,table,crossclassified,3,0,3
15576,bride,chain,crossclassified,3,3,0
4432,leaf,salad,crossclassified,3,0,3
1530,child,snowsuit,crossclassified,3,3,0
2994,door,entrance,hypernymy.2,3,3,0
4714,bed,top,crossclassified,3,3,0
2191,dip,soup,crossclassified,3,0,3
4546,dress,electronics,crossclassified,3,3,0
2964,food,giraffe,crossclassified,3,0,3
4560,elbow,shirt,crossclassified,3,0,3
4566,paddle,pizza,crossclassified,3,0,3
1500,counter,cream,crossclassified,3,3,0
2918,bat,jacket,crossclassified,3,0,3
4646,lunch,pizza,crossclassified,3,0,3
2923,lamb,statue,crossclassified,3,0,3
2924,plant,statue,crossclassified,3,1,2
4588,person,table,crossclassified,3,2,1
2939,boat,bowl,co-hyponymy,3,3,0
4598,case,fruit,crossclassified,3,0,3
2170,cream,cupcake,crossclassified,3,0,3
14704,bed,mellow,crossclassified,3,3,0
2935,jacket,wine,crossclassified,3,3,0
4606,handbag,purse,synonymy,3,0,3
2933,drink,jacket,crossclassified,3,0,3
4542,beans,soup,crossclassified,3,0,3
1466,pot,spoon,co-hyponymy,3,1,2
4669,airplane,building,crossclassified,3,1,2
15227,chair,grass,crossclassified,3,0,3
4488,horse,mare,hypernymy.1,3,3,0
15226,building,overhang,crossclassified,3,3,0
1452,decor,vase,crossclassified,3,0,3
4698,lutenist,woman,crossclassified,3,0,3
4696,carpet,sheet,crossclassified,3,3,0
2900,broccoli,woman,crossclassified,3,0,3
4505,dog,goat,crossclassified,3,0,3
15609,cycle,person,crossclassified,3,0,3
4530,ale,bottle,crossclassified,3,0,3
2976,bracelet,dress,crossclassified,3,0,3
4512,cabana,hut,crossclassified,3,0,3
1518,boy,couple,crossclassified,3,0,3
4686,field,runway,crossclassified,3,0,3
4517,hut,roof,crossclassified,3,2,1
4684,grass,runway,crossclassified,3,0,3
2974,hug,woman,crossclassified,3,0,3
2130,man,television,crossclassified,3,3,0
2221,cat,paper,crossclassified,3,3,0
4967,chair,lap,crossclassified,3,3,0
4184,horse,sea,crossclassified,3,3,0
3129,horse,thoroughbred,hypernymy.1,3,3,0
4193,building,pavilion,crossclassified,3,3,0
1385,duck,flamingo,crossclassified,3,0,3
2276,bird,pole,crossclassified,3,3,0
4921,salad,soup,co-hyponymy,3,1,2
4207,food,person,crossclassified,3,0,3
4212,jacket,kid,crossclassified,3,3,0
15623,bird,prey,crossclassified,3,3,0
4919,crash,horse,crossclassified,3,0,3
15412,building,driveway,crossclassified,3,3,0
4222,pot,vessel,hypernymy.2,3,3,0
4224,shawl,woman,crossclassified,3,0,3
1623,boat,catamaran,crossclassified,3,3,0
2751,pan,vegetables,crossclassified,3,3,0
4903,animal,bison,hypernymy.1,3,3,0
2754,cake,heart,crossclassified,3,3,0
14603,teak,truck,crossclassified,3,0,3
2735,minimization,pizza,crossclassified,3,0,3
4935,book,curtain,crossclassified,3,0,3
2222,coat,court,crossclassified,3,3,0
2094,china,dishes,co-hyponymy,3,3,0
3161,ray,stingray,hypernymy.1,3,0,3
1681,skier,women,crossclassified,3,3,0
3152,fruits,man,crossclassified,3,0,3
4151,girl,television,crossclassified,3,3,0
2092,china,tease,crossclassified,3,3,0
4152,motorcar,motorcycle,co-hyponymy,3,0,3
1376,surfer,trouser,crossclassified,3,3,0
14870,foods,sandwich,hypernymy.1,3,0,3
4158,muffin,sandwich,crossclassified,3,0,3
4159,griddlecake,sandwich,crossclassified,3,0,3
4948,bar,jacket,crossclassified,3,0,3
1378,jacket,shirts,crossclassified,3,3,0
3141,aquarium,container,hypernymy.2,3,0,3
4943,can,table,crossclassified,3,1,2
14588,bus,sidewalk,crossclassified,3,0,3
4169,airplane,animal,crossclassified,3,3,0
4939,beverage,can,crossclassified,3,0,3
4242,helmet,jersey,crossclassified,3,0,3
2755,shampoo,sink,crossclassified,3,0,3
1614,boy,television,crossclassified,3,3,0
14609,motorbike,rug,crossclassified,3,0,3
4329,barrel,planter,crossclassified,3,0,3
4840,pavement,runway,co-hyponymy,3,0,3
2247,frankfurter,hotdog,synonymy,3,0,3
3063,bed,towel,crossclassified,3,3,0
2241,alary,dugout,crossclassified,3,0,3
2238,coat,mobile,crossclassified,3,3,0
2806,bridge,umbrella,crossclassified,3,3,0
2811,cap,plane,crossclassified,3,0,3
14805,bed,bets,crossclassified,3,3,0
4358,hotdog,jam,crossclassified,3,3,0
4820,goalie,person,hypernymy.2,3,3,0
2821,beak,bird,crossclassified,3,0,3
1572,beer,beverage,hypernymy.2,3,3,0
4376,groomsman,man,crossclassified,3,0,3
2827,suitcase,woman,crossclassified,3,0,3
4807,fo,soup,crossclassified,3,0,3
1569,bun,girl,crossclassified,3,0,3
4327,cooker,woman,crossclassified,3,0,3
4852,dress,skater,crossclassified,3,0,3
2119,sink,woman,crossclassified,3,0,3
4287,floor,suit,crossclassified,3,3,0
4252,hair,person,crossclassified,3,3,0
4253,cake,desert,crossclassified,3,3,0
1612,bench,dove,crossclassified,3,3,0
4261,cake,flag,crossclassified,3,3,0
4267,male,player,co-hyponymy,3,0,3
1419,jockey,woman,crossclassified,3,0,3
14833,car,post,crossclassified,3,3,0
3085,donut,nut,crossclassified,3,3,0
14622,cow,fur,crossclassified,3,3,0
15198,catcher,pants,crossclassified,3,3,0
4863,motorcycle,tree,crossclassified,3,3,0
4299,carpet,curtain,co-hyponymy,3,2,1
4301,man,toilet,crossclassified,3,3,0
3078,dresser,suitcase,crossclassified,3,3,0
3076,armoire,dresser,crossclassified,3,0,3
4307,dog,skateboard,crossclassified,3,3,0
5322,bird,rooster,hypernymy.1,3,0,3
5064,girl,outfit,crossclassified,3,3,0
1907,device,mouse,hypernymy.1,3,2,1
3560,gyroplane,plane,co-hyponymy,3,0,3
1911,keyboard,mouse,crossclassified,3,0,3
3527,boy,cycle,crossclassified,3,3,0
15115,jacket,tress,crossclassified,3,3,0
14362,buffet,food,hypernymy.2,3,3,0
5531,building,room,co-hyponymy,3,3,0
2469,carrot,sandwich,crossclassified,3,0,3
3415,chair,window,crossclassified,3,3,0
3643,semitrailer,truck,crossclassified,3,0,3
3397,chair,swimsuit,crossclassified,3,3,0
3525,bicycle,boy,crossclassified,3,0,3
1223,helmet,person,crossclassified,3,1,2
3641,bench,sidewalk,crossclassified,3,3,0
15374,cafe,window,crossclassified,3,0,3
5430,bridge,helmet,crossclassified,3,3,0
5467,pan,stove,crossclassified,3,3,0
3565,pizza,sweater,crossclassified,3,1,2
2504,shed,shelter,crossclassified,3,3,0
3524,boy,cyclist,crossclassified,3,3,0
14424,boy,traveler,crossclassified,3,3,0
3522,hairdresser,woman,crossclassified,3,0,3
5483,boy,carrot,crossclassified,3,3,0
3602,cup,curtain,crossclassified,3,0,3
3417,coat,umbrella,crossclassified,3,3,0
2451,fence,shirt,crossclassified,3,2,1
1289,apparel,man,crossclassified,3,0,3
5368,girl,schoolgirl,hypernymy.1,3,3,0
3608,computer,girl,crossclassified,3,0,3
5418,boy,counter,crossclassified,3,1,2
5474,porcelain,vase,crossclassified,3,0,3
15375,store,window,crossclassified,3,0,3
5528,sofa,t-shirt,crossclassified,3,3,0
2417,bird,brat,crossclassified,3,3,0
5347,butterfly,flower,crossclassified,3,0,3
3713,curtain,stage,crossclassified,3,3,0
3472,athlete,t-shirt,crossclassified,3,3,0
14403,cereal,oatmeal,crossclassified,3,0,3
3408,boat,shipwreck,crossclassified,3,3,0
3543,dress,sundress,hypernymy.1,3,3,0
3659,skate,snowboarder,crossclassified,3,0,3
3716,backdrop,curtain,crossclassified,3,0,3
5516,house,patio,crossclassified,3,3,0
3406,coat,couch,hypernymy.1,3,1,2
3540,dress,tent,crossclassified,3,0,3
3582,girl,racket,crossclassified,3,3,0
2481,man,towel,crossclassified,3,3,0
5413,sandwich,sloppy,crossclassified,3,3,0
3467,brochette,sandwich,crossclassified,3,0,3
1879,girl,house,crossclassified,3,0,3
3578,mirror,vehicle,crossclassified,3,3,0
3551,rider,skater,crossclassified,3,0,3
3411,boy,tot,crossclassified,3,3,0
5401,jacket,turtleneck,crossclassified,3,3,0
3434,backpack,skater,crossclassified,3,0,3
5523,footballer,man,crossclassified,3,0,3
5343,cream,donut,crossclassified,3,0,3
3558,box,carpet,crossclassified,3,0,3
1914,arms,shirt,crossclassified,3,0,3
5355,macaroni,pasta,hypernymy.2,3,0,3
3695,horse,truck,crossclassified,3,1,2
15031,basket,goal,hypernymy.2,3,0,3
5489,bird,buzzard,hypernymy.1,3,3,0
3571,boot,woman,crossclassified,3,0,3
1290,man,shoes,crossclassified,3,3,0
15022,goal,tent,crossclassified,3,3,0
1272,cat,legs,crossclassified,3,3,0
3729,dress,suitcase,crossclassified,3,3,0
1957,cup,wine,crossclassified,3,0,3
3573,chicken,seasoning,crossclassified,3,3,0
14370,dugout,wheel,crossclassified,3,3,0
5329,class,person,hypernymy.1,3,0,3
3630,bat,truck,crossclassified,3,0,3
3614,garage,shoe,crossclassified,3,3,0
14386,boy,teeth,crossclassified,3,3,0
2435,knife,sandwich,crossclassified,3,1,2
15098,aqueducts,bridge,crossclassified,3,0,3
2474,hat,skater,crossclassified,3,0,3
1939,man,teacher,crossclassified,3,3,0
3622,elephant,girl,crossclassified,3,0,3
3689,cow,pig,crossclassified,3,3,0
14371,carpet,fruit,crossclassified,3,3,0
5381,gymnast,woman,crossclassified,3,0,3
3635,inner,shirt,crossclassified,3,0,3
13352,hippie,woman,crossclassified,2,0,2
12070,furniture,room,crossclassified,2,2,0
10103,dropline,plane,crossclassified,2,0,2
13351,peon,woman,crossclassified,2,0,2
10144,bench,dresses,crossclassified,2,2,0
4323,bacon,sandwich,crossclassified,2,2,0
15573,bride,t-shirt,crossclassified,2,2,0
12027,knife,skewer,crossclassified,2,2,0
14822,fillings,meat,crossclassified,2,0,2
12030,cords,desk,crossclassified,2,0,2
14792,porch,restaurant,crossclassified,2,0,2
14796,coke,pizza,crossclassified,2,0,2
10107,pan,sweet,crossclassified,2,2,0
7729,bad,child,crossclassified,2,0,2
7727,shirt,suspenders,crossclassified,2,2,0
1579,boy,eating,crossclassified,2,2,0
7723,jacket,suitcase,crossclassified,2,2,0
13357,cow,hat,crossclassified,2,2,0
10113,house,jersey,crossclassified,2,2,0
13359,bench,jeans,crossclassified,2,2,0
7746,flower,horse,crossclassified,2,0,2
12073,car,windows,crossclassified,2,2,0
7610,can,van,crossclassified,2,0,2
10181,bull,light,crossclassified,2,2,0
13416,camera,temple,crossclassified,2,0,2
1600,appetizer,pizza,crossclassified,2,0,2
12486,cat,dresser,crossclassified,2,0,2
7602,scarf,sweater,co-hyponymy,2,0,2
15507,bunked,tress,crossclassified,2,2,0
12081,animal,motorcycle,crossclassified,2,0,2
3584,blood,shirt,crossclassified,2,0,2
15091,foot,man,crossclassified,2,0,2
9146,reflection,spoon,crossclassified,2,0,2
7763,jeep,van,crossclassified,2,1,1
4382,bird,canary,hypernymy.1,2,2,0
7761,blanket,sheets,crossclassified,2,2,0
13342,barn,roof,crossclassified,2,1,1
12492,carpet,vase,crossclassified,2,2,0
13343,roof,shed,crossclassified,2,2,0
7607,giraffe,hut,crossclassified,2,0,2
9330,board,skier,crossclassified,2,0,2
3478,bridge,overhang,crossclassified,2,2,0
7608,animal,hut,crossclassified,2,0,2
4309,floor,wooden,crossclassified,2,2,0
1587,plushy,toy,crossclassified,2,0,2
15571,girl,show,crossclassified,2,2,0
7609,camper,van,hypernymy.1,2,0,2
4316,shirt,teddy,crossclassified,2,2,0
4374,elderly,man,crossclassified,2,0,2
7747,shirt,toys,crossclassified,2,2,0
9126,cucumber,food,hypernymy.2,2,0,2
7716,highway,road,hypernymy.2,2,0,2
10115,car,intersection,crossclassified,2,2,0
625,bird,fowl,synonymy,2,2,0
13374,person,torso,crossclassified,2,2,0
7690,mom,shirt,crossclassified,2,0,2
4337,fountain,planter,crossclassified,2,0,2
4352,chair,water,crossclassified,2,2,0
10129,bridge,cap,crossclassified,2,2,0
15209,horse,plate,crossclassified,2,2,0
201,boy,sunglasses,crossclassified,2,2,0
2122,cap,umpire,crossclassified,2,0,2
12047,bat,car,crossclassified,2,0,2
10134,car,suit,crossclassified,2,0,2
326,couch,player,crossclassified,2,2,0
7681,fan,plane,crossclassified,2,0,2
14811,sheep,truck,crossclassified,2,0,2
14806,microwave,woman,crossclassified,2,0,2
3059,gloves,skier,crossclassified,2,0,2
7674,lantern,vase,crossclassified,2,0,2
10149,bag,snowboarder,crossclassified,2,0,2
7673,bench,women,crossclassified,2,2,0
617,chair,guy,crossclassified,2,2,0
10145,contestant,woman,crossclassified,2,0,2
9322,desk,watch,crossclassified,2,2,0
13386,bench,stele,crossclassified,2,2,0
12605,counter,wheel,co-hyponymy,2,2,0
4346,arms,carpet,crossclassified,2,0,2
10141,dugout,room,crossclassified,2,2,0
10142,giraffe,mirage,crossclassified,2,2,0
7668,headphone,woman,crossclassified,2,0,2
1576,machine,shirt,crossclassified,2,0,2
13385,backpack,boy,crossclassified,2,0,2
7648,cake,wood,crossclassified,2,2,0
12604,bicycle,counter,crossclassified,2,0,2
13372,handle,motorcycle,crossclassified,2,0,2
13364,cow,vehicle,crossclassified,2,2,0
7665,bagel,cheese,crossclassified,2,2,0
12031,carpet,loveseat,crossclassified,2,2,0
7628,fork,woman,crossclassified,2,0,2
10168,dinner,sandwich,crossclassified,2,0,2
12612,pizzas,table,crossclassified,2,0,2
12063,plane,steel,crossclassified,2,2,0
7713,man,shrift,crossclassified,2,2,0
4361,furniture,stove,crossclassified,2,0,2
7712,pica,pizza,crossclassified,2,0,2
13362,painter,person,hypernymy.2,2,0,2
15211,bed,toddler,crossclassified,2,2,0
13363,artist,person,hypernymy.2,2,0,2
12060,car,skate,crossclassified,2,2,0
10120,mirror,vanity,crossclassified,2,2,0
13398,dog,float,crossclassified,2,2,0
12603,counter,cycle,crossclassified,2,2,0
4335,bowl,planter,crossclassified,2,1,1
10164,donut,sprinkles,crossclassified,2,2,0
10163,horse,police,crossclassified,2,2,0
7637,walking,woman,crossclassified,2,0,2
7703,cookware,pot,hypernymy.1,2,0,2
7700,mixer,pot,crossclassified,2,0,2
15205,building,pizza,crossclassified,2,2,0
7698,appliance,pot,crossclassified,2,0,2
12042,bed,bun,crossclassified,2,2,0
7697,pot,vat,co-hyponymy,2,2,0
9327,lady,skier,crossclassified,2,0,2
10125,display,mirror,crossclassified,2,0,2
3392,plate,vase,crossclassified,2,0,2
591,building,lamppost,crossclassified,2,2,0
13332,building,shack,crossclassified,2,2,0
13270,cheetah,tiger,co-hyponymy,2,2,0
3116,meat,table,crossclassified,2,0,2
1892,pillow,toy,crossclassified,2,2,0
3124,clothes,man,crossclassified,2,0,2
10010,happy,woman,crossclassified,2,0,2
10009,prow,zebra,crossclassified,2,0,2
10008,jacket,shawl,crossclassified,2,2,0
4201,bench,cake,crossclassified,2,2,0
13269,cat,cheetah,hypernymy.1,2,0,2
12138,highchair,spoon,crossclassified,2,2,0
13268,animal,cheetah,hypernymy.1,2,0,2
12479,bed,tile,crossclassified,2,2,0
1648,bathrooms,toilet,synonymy,2,0,2
9354,dog,retriever,hypernymy.1,2,2,0
15561,eyes,hat,crossclassified,2,0,2
9076,boxer,dog,hypernymy.2,2,0,2
10000,bottle,box,co-hyponymy,2,2,0
12635,couch,cushions,crossclassified,2,2,0
12127,airplane,racket,crossclassified,2,2,0
10021,children,house,crossclassified,2,0,2
7901,man,wine,crossclassified,2,2,0
12118,bar,desk,crossclassified,2,1,1
3113,entree,table,crossclassified,2,0,2
1969,man,parent,crossclassified,2,2,0
4220,child,glasses,crossclassified,2,2,0
7890,building,pillow,crossclassified,2,2,0
3604,cupboard,curtain,crossclassified,2,0,2
9085,football,woman,crossclassified,2,0,2
9351,boy,outfielder,crossclassified,2,2,0
7891,building,pul,crossclassified,2,2,0
12120,bench,feet,crossclassified,2,2,0
1633,fedora,man,crossclassified,2,0,2
14851,dugout,shirts,crossclassified,2,2,0
10026,fruits,woman,crossclassified,2,0,2
9083,bowl,onion,crossclassified,2,2,0
3114,paler,table,crossclassified,2,0,2
4190,lambs,sheep,crossclassified,2,0,2
12139,highchair,t-shirt,crossclassified,2,2,0
12117,bar,shelf,co-hyponymy,2,2,0
4163,man,sand,crossclassified,2,2,0
3455,jacket,mouth,crossclassified,2,2,0
530,console,dresser,co-hyponymy,2,0,2
13242,house,sidewalk,crossclassified,2,2,0
3616,cat,parrot,crossclassified,2,2,0
4168,cereal,fruit,crossclassified,2,2,0
3620,counter,mix,crossclassified,2,2,0
7973,sash,shirt,crossclassified,2,0,2
9975,bookshelf,man,crossclassified,2,2,0
13260,hood,woman,crossclassified,2,2,0
9973,coach,person,hypernymy.2,2,0,2
3621,counter,juice,crossclassified,2,2,0
3145,couch,kids,crossclassified,2,2,0
9059,laptop,t-shirt,crossclassified,2,2,0
7981,sign,tent,crossclassified,2,0,2
7987,girl,wall,crossclassified,2,2,0
7988,countertop,woman,crossclassified,2,0,2
15559,coke,hat,crossclassified,2,0,2
7964,field,grassland,co-hyponymy,2,2,0
7963,field,prairie,crossclassified,2,2,0
9067,shoe,sneakers,hypernymy.1,2,2,0
339,eat,girl,crossclassified,2,0,2
14861,matte,rug,crossclassified,2,0,2
13259,ball,dress,crossclassified,2,0,2
7939,tent,wooden,crossclassified,2,2,0
9355,bagel,pastry,crossclassified,2,2,0
9996,pineapple,pizza,crossclassified,2,0,2
12145,bib,highchair,crossclassified,2,0,2
9990,cub,hotdog,crossclassified,2,0,2
12146,bed,chaise,crossclassified,2,2,0
9072,bandana,woman,crossclassified,2,0,2
7953,chalet,house,hypernymy.2,2,0,2
13251,horse,mouth,crossclassified,2,2,0
15054,cabinet,storage,crossclassified,2,2,0
14868,couch,mellow,crossclassified,2,2,0
7961,field,shoe,crossclassified,2,2,0
7884,wine,wineglass,crossclassified,2,2,0
13289,car,store,crossclassified,2,2,0
10082,jacket,jumpsuit,crossclassified,2,2,0
7819,airplane,eel,crossclassified,2,2,0
4282,cake,chicken,crossclassified,2,2,0
4281,cloth,man,crossclassified,2,0,2
3088,sneakers,woman,crossclassified,2,0,2
10065,cow,truck,crossclassified,2,0,2
7812,couch,short,crossclassified,2,2,0
10063,truck,turk,crossclassified,2,2,0
3092,flower,umbrella,crossclassified,2,0,2
3592,baby,skier,crossclassified,2,0,2
1899,giraffe,trees,crossclassified,2,2,0
4265,female,skater,crossclassified,2,0,2
13312,bread,fish,crossclassified,2,0,2
7823,dog,pul,crossclassified,2,2,0
9101,bench,sleeveless,crossclassified,2,2,0
4258,mug,shirt,crossclassified,2,0,2
12625,microwave,shirt,crossclassified,2,1,1
10057,carpet,frisbee,crossclassified,2,2,0
7804,cow,doll,crossclassified,2,2,0
3086,desert,donut,crossclassified,2,0,2
12092,shelf,shirt,crossclassified,2,2,0
13321,dugout,pavilion,crossclassified,2,2,0
7779,desk,mousepad,crossclassified,2,2,0
4297,girl,tennis,crossclassified,2,2,0
1901,leaf,sandwich,crossclassified,2,0,2
7782,earphone,plane,crossclassified,2,0,2
4295,fridge,shirt,crossclassified,2,0,2
4292,car,fender,crossclassified,2,2,0
9110,bird,feathers,crossclassified,2,2,0
337,donut,girl,crossclassified,2,0,2
4286,bridle,horse,crossclassified,2,0,2
7793,sandwich,spoon,crossclassified,2,2,0
10074,apple,friulian,crossclassified,2,2,0
15215,animal,boy,crossclassified,2,0,2
9106,fruit,strawberry,hypernymy.1,2,1,1
14834,car,hole,crossclassified,2,2,0
7799,house,sweater,crossclassified,2,2,0
13307,airplane,motorcycle,crossclassified,2,2,0
3097,umbrella,vegetable,crossclassified,2,2,0
4225,smoker,woman,crossclassified,2,0,2
10043,jesus,statue,crossclassified,2,0,2
14843,collar,tie,crossclassified,2,0,2
9348,dress,snowboarder,crossclassified,2,0,2
7858,grill,hood,crossclassified,2,0,2
3601,curtain,drink,crossclassified,2,2,0
4238,trousers,woman,crossclassified,2,0,2
13295,cruller,donut,co-hyponymy,2,0,2
3106,boy,youngster,crossclassified,2,2,0
9090,onion,vegetables,hypernymy.2,2,0,2
9344,cactus,flower,crossclassified,2,0,2
12110,bench,top,crossclassified,2,2,0
7870,desk,donuts,crossclassified,2,2,0
12111,animal,cabinet,crossclassified,2,0,2
12113,bar,countertop,crossclassified,2,2,0
12114,bar,glasses,crossclassified,2,2,0
7875,car,leg,crossclassified,2,2,0
7876,car,jeans,crossclassified,2,2,0
7854,toddler,woman,crossclassified,2,0,2
9347,bellow,chair,crossclassified,2,0,2
14842,mug,tea,crossclassified,2,2,0
4244,bird,pheasant,hypernymy.1,2,2,0
4250,horse,silhouette,crossclassified,2,2,0
4249,airings,jacket,crossclassified,2,0,2
4248,cumberland,woman,crossclassified,2,0,2
9097,microphone,suit,crossclassified,2,0,2
7837,basil,pizza,crossclassified,2,0,2
7838,marinara,pizza,crossclassified,2,0,2
7839,chair,rope,crossclassified,2,2,0
10054,sink,transmission,crossclassified,2,2,0
7842,potato,salad,crossclassified,2,0,2
7843,salad,slaw,hypernymy.1,2,2,0
15757,seat,sheet,crossclassified,2,2,0
9345,flower,unknown,crossclassified,2,2,0
7848,bowl,tomatoes,crossclassified,2,2,0
7849,bowl,furniture,crossclassified,2,2,0
3599,cellphone,dress,crossclassified,2,0,2
3037,jacket,rider,crossclassified,2,2,0
3032,coat,surfer,crossclassified,2,0,2
13419,shrine,temple,co-hyponymy,2,0,2
10340,airplane,sky,crossclassified,2,2,0
4534,motorcycle,quad,crossclassified,2,2,0
14735,awning,bus,crossclassified,2,2,0
709,blender,holder,crossclassified,2,2,0
10349,blender,bread,crossclassified,2,2,0
4528,pizza,sweet,crossclassified,2,2,0
10346,dog,fields,crossclassified,2,2,0
2149,man,repairman,crossclassified,2,2,0
11923,cookie,counter,crossclassified,2,0,2
7335,goat,house,crossclassified,2,0,2
11925,desk,sofa,crossclassified,2,2,0
4522,boy,toilet,crossclassified,2,2,0
7326,knife,silverware,crossclassified,2,2,0
11927,mate,rug,crossclassified,2,0,2
13542,cake,ring,crossclassified,2,2,0
13541,boot,carpet,crossclassified,2,0,2
10330,house,lodge,hypernymy.1,2,2,0
11912,bottle,floor,crossclassified,2,0,2
7300,biscuit,cake,hypernymy.2,2,0,2
9231,bottle,lotion,crossclassified,2,2,0
13556,kite,tree,crossclassified,2,2,0
13566,plate,waffle,crossclassified,2,0,2
10364,bench,handbag,crossclassified,2,2,0
11905,clock,lamppost,crossclassified,2,2,0
4551,vessels,woman,crossclassified,2,0,2
7281,dog,terrier,hypernymy.1,2,2,0
7283,apricot,fruit,hypernymy.2,2,0,2
1933,chain,train,co-hyponymy,2,0,2
7289,helmet,tent,crossclassified,2,0,2
7291,tent,tilt,crossclassified,2,2,0
7292,crowd,tent,crossclassified,2,0,2
10357,car,skateboarder,crossclassified,2,2,0
13558,kite,pole,crossclassified,2,2,0
2965,giraffe,t-shirt,crossclassified,2,2,0
4540,bridge,turntable,crossclassified,2,2,0
12552,crib,dress,crossclassified,2,2,0
13540,awning,elephant,crossclassified,2,0,2
7336,fence,shoe,crossclassified,2,2,0
11901,toyota,truck,crossclassified,2,0,2
10307,board,wood,crossclassified,2,2,0
7365,mirror,wall,crossclassified,2,2,0
12523,closet,wall,crossclassified,2,0,2
10310,board,platform,crossclassified,2,2,0
4500,goat,shirt,crossclassified,2,2,0
10309,board,floor,crossclassified,2,1,1
15502,scooter,tyre,crossclassified,2,2,0
3538,tent,woman,crossclassified,2,2,0
2990,motorbike,woman,crossclassified,2,0,2
1947,equestrians,horse,crossclassified,2,0,2
7375,sandwich,troat,crossclassified,2,2,0
10304,board,glows,crossclassified,2,2,0
14752,bowl,can,co-hyponymy,2,2,0
2991,doormat,rug,crossclassified,2,0,2
10302,board,watch,crossclassified,2,2,0
4494,carpet,cup,crossclassified,2,2,0
15739,grill,meal,crossclassified,2,2,0
11939,railing,train,crossclassified,2,0,2
7362,goggles,snowboarder,crossclassified,2,0,2
1925,bridge,elevated,crossclassified,2,2,0
15085,cap,glove,crossclassified,2,0,2
13539,elephant,tent,crossclassified,2,2,0
9225,bird,braid,crossclassified,2,2,0
1932,carrot,jacket,crossclassified,2,0,2
2975,boots,woman,crossclassified,2,0,2
7342,fence,player,crossclassified,2,2,0
10326,bird,building,crossclassified,2,0,2
9221,outhouse,structure,hypernymy.2,2,2,0
3531,child,sweatshirt,crossclassified,2,2,0
299,automobile,hood,crossclassified,2,0,2
2980,inner,woman,crossclassified,2,0,2
7348,raft,shirt,crossclassified,2,2,0
11935,drain,toilet,crossclassified,2,0,2
13529,clothes,tie,crossclassified,2,0,2
4506,man,reader,crossclassified,2,2,0
7360,automobile,bridge,crossclassified,2,0,2
2962,car,toyota,crossclassified,2,2,0
10370,handbag,jacket,crossclassified,2,0,2
10186,cake,tent,crossclassified,2,0,2
7203,handbag,train,crossclassified,2,0,2
10414,case,woman,co-hyponymy,2,0,2
13607,boat,shop,crossclassified,2,2,0
7195,bread,fries,crossclassified,2,2,0
3512,hotdog,napkin,crossclassified,2,2,0
4600,fruit,jar,crossclassified,2,1,1
7201,sheep,wooden,crossclassified,2,2,0
1937,boy,guitarist,crossclassified,2,2,0
10408,color,dog,crossclassified,2,0,2
10402,boat,horse,crossclassified,2,2,0
7206,curtain,wooden,crossclassified,2,2,0
7207,curtain,winos,crossclassified,2,2,0
1944,floor,mobile,crossclassified,2,2,0
15804,bag,bridge,crossclassified,2,0,2
11883,pole,storefront,crossclassified,2,0,2
15594,bridge,rope,crossclassified,2,2,0
4589,overalls,shirt,crossclassified,2,0,2
11875,pot,salad,crossclassified,2,2,0
7191,cat,cloth,crossclassified,2,2,0
10416,chair,class,crossclassified,2,2,0
4603,purse,shirt,crossclassified,2,2,0
14712,broccoli,spoon,crossclassified,2,0,2
7174,cow,livestock,co-hyponymy,2,2,0
10423,food,leftovers,hypernymy.1,2,2,0
15237,animal,bookshelf,crossclassified,2,0,2
13618,cheese,meat,co-hyponymy,2,0,2
12536,counter,toolbox,crossclassified,2,2,0
1943,floor,hall,hypernymy.2,2,2,0
7180,sink,sofa,crossclassified,2,1,1
14715,fork,snakes,crossclassified,2,2,0
13616,basket,bowl,co-hyponymy,2,0,2
10419,dog,wall,crossclassified,2,2,0
11874,pot,stew,crossclassified,2,2,0
13613,cycle,storefront,crossclassified,2,0,2
3505,bowler,man,crossclassified,2,0,2
7188,batter,belt,crossclassified,2,2,0
12531,bench,memorial,crossclassified,2,2,0
9267,dog,tile,crossclassified,2,2,0
4558,boy,eater,crossclassified,2,2,0
7254,cellphone,girl,crossclassified,2,0,2
14726,awning,depot,crossclassified,2,2,0
13580,bread,foot,crossclassified,2,2,0
13579,kid,pitcher,crossclassified,2,0,2
2953,cheese,plate,crossclassified,2,2,0
13578,gloves,pitcher,crossclassified,2,0,2
7252,girl,vest,crossclassified,2,2,0
15078,armoire,door,crossclassified,2,0,2
1502,cow,sofa,crossclassified,2,2,0
4587,eater,person,hypernymy.2,2,0,2
15076,commuter,desk,crossclassified,2,0,2
4565,customer,man,crossclassified,2,0,2
10377,cage,table,crossclassified,2,0,2
7263,peacock,turkey,crossclassified,2,1,1
9237,baby,jacket,crossclassified,2,0,2
10374,table,umbrella,crossclassified,2,1,1
10371,tonal,woman,crossclassified,2,0,2
9269,ledge,wall,crossclassified,2,0,2
10386,class,counter,crossclassified,2,0,2
14723,doubleheader,train,crossclassified,2,0,2
4583,horse,pants,crossclassified,2,2,0
2169,cupcake,flower,crossclassified,2,2,0
13599,cover,shirt,crossclassified,2,0,2
13598,carpet,comforter,crossclassified,2,2,0
10400,boat,inflatable,crossclassified,2,2,0
4585,building,poster,crossclassified,2,2,0
7224,food,hand,crossclassified,2,0,2
11887,patio,storefront,crossclassified,2,0,2
10396,bench,snack,crossclassified,2,2,0
7228,asparagus,broccoli,crossclassified,2,0,2
7229,broccoli,cheese,crossclassified,2,2,0
12543,booth,wall,crossclassified,2,2,0
10395,cup,tumbler,crossclassified,2,2,0
765,fabric,table,crossclassified,2,0,2
10390,floor,woman,crossclassified,2,1,1
10388,egg,table,crossclassified,2,0,2
13517,stem,vase,crossclassified,2,0,2
10300,cow,pony,crossclassified,2,2,0
7385,liquid,soup,crossclassified,2,0,2
7535,door,furniture,crossclassified,2,2,0
11994,beach,bird,crossclassified,2,0,2
1909,mouse,plate,crossclassified,2,2,0
11996,bird,ocean,crossclassified,2,2,0
9167,bag,suitcase,synonymy,2,0,2
12580,cabinet,girl,crossclassified,2,2,0
7532,door,wooden,crossclassified,2,2,0
10221,jacket,snack,crossclassified,2,2,0
10219,boy,desert,crossclassified,2,2,0
12589,beach,ground,crossclassified,2,2,0
14778,motorcycle,window,crossclassified,2,0,2
13446,motorcycle,tarp,crossclassified,2,2,0
15747,building,skateboarder,crossclassified,2,2,0
7540,door,wall,crossclassified,2,2,0
12582,cabinet,child,crossclassified,2,2,0
1951,plate,skater,crossclassified,2,0,2
12000,cabinet,tile,crossclassified,2,2,0
7523,bookshelf,furniture,crossclassified,2,2,0
15066,fork,utensils,crossclassified,2,2,0
11993,bird,shore,crossclassified,2,2,0
4426,gunman,man,crossclassified,2,0,2
7506,dixie,pitcher,crossclassified,2,0,2
10235,fess,woman,crossclassified,2,0,2
4433,cabbage,salad,crossclassified,2,1,1
12508,carpet,counter,crossclassified,2,2,0
7509,plate,zebra,crossclassified,2,0,2
9175,cup,shelf,crossclassified,2,0,2
4430,man,water,crossclassified,2,2,0
10234,bet,dresser,crossclassified,2,0,2
10232,pots,table,crossclassified,2,0,2
9174,rake,shelf,crossclassified,2,0,2
15788,building,city,crossclassified,2,2,0
10231,table,top,crossclassified,2,2,0
3567,cake,sweater,crossclassified,2,0,2
10230,jug,table,crossclassified,2,0,2
13453,broccoli,topping,crossclassified,2,2,0
9159,airplane,propellors,crossclassified,2,2,0
3570,sweater,top,crossclassified,2,2,0
4492,carpet,short,crossclassified,2,2,0
7586,coat,snow,crossclassified,2,0,2
10198,donuts,snacks,crossclassified,2,2,0
14787,dress,restaurant,crossclassified,2,0,2
4389,boy,giraffe,crossclassified,2,2,0
10197,child,rider,crossclassified,2,2,0
12015,jet,wings,crossclassified,2,2,0
4387,backpack,floor,crossclassified,2,0,2
12017,bridge,vehicles,crossclassified,2,2,0
7587,pole,snow,crossclassified,2,0,2
4407,bowl,shrimp,crossclassified,2,2,0
12595,carpet,girls,crossclassified,2,2,0
14790,patio,restaurant,crossclassified,2,0,2
10189,fine,table,crossclassified,2,0,2
7591,skateboard,snow,crossclassified,2,0,2
640,bowl,veggies,crossclassified,2,2,0
7595,bathtub,bottle,co-hyponymy,2,2,0
315,athlete,skater,hypernymy.1,2,0,2
4393,lamp,t-shirt,crossclassified,2,2,0
12011,curtain,shadow,crossclassified,2,2,0
9056,tie,torso,crossclassified,2,2,0
7569,carpet,hand,crossclassified,2,2,0
7548,step,table,crossclassified,2,0,2
10215,hairbrush,shirt,crossclassified,2,0,2
9314,transportation,truck,crossclassified,2,0,2
192,jacket,people,crossclassified,2,2,0
12007,bench,men,crossclassified,2,2,0
12500,box,tray,crossclassified,2,2,0
1568,custom,man,crossclassified,2,0,2
7558,child,shirts,crossclassified,2,2,0
4397,bottle,coke,crossclassified,2,2,0
7561,sink,trough,co-hyponymy,2,0,2
7562,tank,trough,crossclassified,2,0,2
4396,hooker,woman,hypernymy.2,2,0,2
7565,pool,trough,crossclassified,2,0,2
12594,carpet,children,crossclassified,2,2,0
10203,guy,shirt,crossclassified,2,0,2
3018,jacket,tag,crossclassified,2,2,0
7498,hat,slouch,crossclassified,2,2,0
9301,counter,windowsill,crossclassified,2,2,0
11960,bridge,fries,crossclassified,2,2,0
2137,surfboard,umbrella,crossclassified,2,0,2
13501,box,dresser,crossclassified,2,0,2
12518,art,bench,crossclassified,2,0,2
15789,leek,veg,hypernymy.2,2,2,0
10276,baby,man,co-hyponymy,2,0,2
10273,hackney,horse,hypernymy.2,2,0,2
4473,bathroom,child,crossclassified,2,0,2
14760,child,fess,crossclassified,2,2,0
13465,boat,men,crossclassified,2,2,0
9290,car,trees,crossclassified,2,2,0
7433,carpet,electronic,crossclassified,2,2,0
7434,bull,horn,crossclassified,2,2,0
7435,bull,steer,co-hyponymy,2,2,0
2135,pole,umbrella,crossclassified,2,0,2
3487,dress,sink,crossclassified,2,0,2
13492,boy,door,crossclassified,2,2,0
10283,shoo,train,crossclassified,2,0,2
10284,diner,shirt,crossclassified,2,0,2
11952,ceramic,vase,crossclassified,2,0,2
10286,camera,truck,crossclassified,2,0,2
9211,bed,flower,crossclassified,2,2,0
4487,napkin,shirt,co-hyponymy,2,0,2
9285,car,grill,crossclassified,2,2,0
2993,door,wheel,crossclassified,2,2,0
13511,bucket,plate,co-hyponymy,2,2,0
11949,jacket,rug,crossclassified,2,0,2
7400,motorcyclist,woman,crossclassified,2,0,2
7401,automobile,woman,crossclassified,2,0,2
15082,cabinet,face,crossclassified,2,2,0
15070,jacket,jerkin,hypernymy.1,2,2,0
12562,balloons,table,crossclassified,2,0,2
7405,awning,boat,crossclassified,2,0,2
4483,bathtub,screen,crossclassified,2,2,0
10288,couch,joystick,crossclassified,2,2,0
7409,coat,table,crossclassified,2,0,2
7440,automobile,desk,crossclassified,2,0,2
3486,brush,sink,crossclassified,2,0,2
4465,dugout,playing,crossclassified,2,2,0
7466,booth,wood,crossclassified,2,2,0
7471,sandwich,wrapper,crossclassified,2,2,0
7472,bong,bottle,crossclassified,2,0,2
3011,bottle,grinds,crossclassified,2,2,0
13472,robe,sari,crossclassified,2,2,0
11977,floor,hallway,crossclassified,2,2,0
13471,jet,monoplane,co-hyponymy,2,2,0
4447,skateboard,skating,crossclassified,2,2,0
4446,shoes,skateboard,crossclassified,2,0,2
7485,curtains,light,crossclassified,2,2,0
7486,curtains,drapes,synonymy,2,2,0
9180,pone,spoon,crossclassified,2,0,2
4444,leg,skateboard,crossclassified,2,0,2
15577,bride,person,hypernymy.2,2,2,0
13467,shadow,table,crossclassified,2,0,2
11981,canoe,kayak,hypernymy.1,2,0,2
4453,baker,girl,crossclassified,2,0,2
662,faucet,tap,hypernymy.1,2,2,0
12570,counter,toothbrushes,crossclassified,2,2,0
7464,boy,electronics,crossclassified,2,2,0
12512,chair,shorts,crossclassified,2,2,0
4464,seller,woman,crossclassified,2,0,2
13488,counter,mugs,crossclassified,2,2,0
7448,bite,food,hypernymy.2,2,0,2
4461,drinker,man,crossclassified,2,0,2
1540,pan,vegetable,crossclassified,2,2,0
9190,bread,hoagie,crossclassified,2,2,0
7453,donuts,dress,crossclassified,2,0,2
15506,basin,bathtub,co-hyponymy,2,0,2
7454,donut,dress,crossclassified,2,1,1
7456,trophy,vase,crossclassified,2,0,2
13481,bear,cub,crossclassified,2,2,0
13478,cloths,robe,crossclassified,2,0,2
4456,humans,woman,crossclassified,2,0,2
4455,jacket,water,crossclassified,2,2,0
7989,ladies,woman,hypernymy.2,2,0,2
3628,sheet,table,crossclassified,2,0,2
4154,cloth,girl,crossclassified,2,0,2
9634,donuts,tray,crossclassified,2,2,0
12331,stand,television,crossclassified,2,2,0
9457,veterinarian,woman,crossclassified,2,0,2
8552,catcher,net,crossclassified,2,2,0
3849,engine,motorcycle,crossclassified,2,0,2
8557,boy,paper,crossclassified,2,2,0
12336,mirror,shower,crossclassified,2,2,0
12930,man,stool,crossclassified,2,2,0
3709,soup,woman,crossclassified,2,0,2
3707,boy,scarf,crossclassified,2,2,0
8891,blanket,clothing,crossclassified,2,2,0
12926,cabinet,case,co-hyponymy,2,2,0
9632,clothing,surfer,crossclassified,2,0,2
12338,mirror,reflection,crossclassified,2,2,0
12339,animal,mirror,crossclassified,2,0,2
9627,girl,tie,crossclassified,2,2,0
9626,airplane,ground,crossclassified,2,2,0
9646,bellow,child,crossclassified,2,0,2
1799,rack,truck,crossclassified,2,0,2
3453,girl,toys,crossclassified,2,2,0
3867,dress,food,crossclassified,2,2,0
9451,phone,suit,crossclassified,2,0,2
8518,towel,tub,crossclassified,2,0,2
12422,mobile,van,crossclassified,2,0,2
1990,cake,craft,crossclassified,2,2,0
8899,corn,fork,crossclassified,2,0,2
8524,dresser,handle,crossclassified,2,2,0
8897,desk,machine,crossclassified,2,2,0
9455,blender,user,crossclassified,2,2,0
2035,florist,man,crossclassified,2,0,2
8531,bench,gown,crossclassified,2,2,0
12950,grill,hotdog,crossclassified,2,2,0
3321,dogs,sheep,crossclassified,2,0,2
12946,man,scarf,crossclassified,2,2,0
9651,car,gate,crossclassified,2,2,0
14976,floor,plaza,crossclassified,2,2,0
9649,building,hat,crossclassified,2,1,1
3710,bouquet,vase,crossclassified,2,0,2
8576,condiments,hotdog,crossclassified,2,0,2
8889,blanket,robe,crossclassified,2,2,0
8611,bared,food,crossclassified,2,0,2
8605,bed,coat,crossclassified,2,2,0
3405,building,monument,co-hyponymy,2,2,0
422,counter,shelve,crossclassified,2,2,0
9611,butterfly,jewelry,crossclassified,2,2,0
8608,stone,vase,crossclassified,2,0,2
9610,broach,butterfly,crossclassified,2,0,2
14990,cellphone,person,crossclassified,2,0,2
12906,boat,vest,crossclassified,2,2,0
3835,armchair,carpet,crossclassified,2,0,2
9609,butterfly,pin,crossclassified,2,2,0
3819,cake,pancake,hypernymy.1,2,1,1
9607,bathtub,floor,crossclassified,2,2,0
1811,bed,handbag,crossclassified,2,2,0
8871,man,sunglass,crossclassified,2,2,0
8619,carpet,glass,crossclassified,2,2,0
3814,bouquet,cake,crossclassified,2,0,2
8604,goggles,man,crossclassified,2,0,2
425,building,facade,crossclassified,2,2,0
8599,man,sky,crossclassified,2,2,0
3826,boat,boating,crossclassified,2,2,0
3338,cabinet,paper,crossclassified,2,2,0
8581,boy,dog,crossclassified,2,1,1
14987,baby,tub,crossclassified,2,0,2
8585,motorcycles,pavement,crossclassified,2,2,0
8887,blanket,man,crossclassified,2,1,1
2024,ground,rug,crossclassified,2,0,2
8589,cup,scissors,crossclassified,2,2,0
3829,skater,sweater,crossclassified,2,2,0
15030,game,goal,co-hyponymy,2,0,2
8593,can,cup,co-hyponymy,2,0,2
8881,blanket,cushion,co-hyponymy,2,2,0
8879,board,zebra,crossclassified,2,0,2
8594,camera,horse,crossclassified,2,0,2
9615,bench,share,crossclassified,2,2,0
8877,blender,miser,crossclassified,2,2,0
12736,auto,van,crossclassified,2,0,2
9664,sink,storage,crossclassified,2,2,0
8908,house,pant,crossclassified,2,2,0
9702,dustbin,sink,crossclassified,2,0,2
8436,bahamian,sandwich,crossclassified,2,0,2
8438,bag,knife,crossclassified,2,0,2
12428,jacket,plane,crossclassified,2,0,2
9709,awning,overhang,crossclassified,2,2,0
8442,spectacle,woman,crossclassified,2,0,2
3694,man,nerd,crossclassified,2,2,0
9703,curtain,remote,crossclassified,2,2,0
9701,cage,horse,crossclassified,2,0,2
14959,temple,tower,crossclassified,2,0,2
12989,house,shorts,crossclassified,2,2,0
12988,house,skater,crossclassified,2,2,0
12308,bottle,stand,crossclassified,2,2,0
12986,girl,money,crossclassified,2,2,0
9698,jeans,shoe,crossclassified,2,0,2
8458,counter,sauce,crossclassified,2,2,0
8459,cheese,counter,crossclassified,2,0,2
3281,container,pan,hypernymy.1,2,0,2
3279,meal,pan,crossclassified,2,0,2
9715,awning,structure,crossclassified,2,2,0
12302,fan,propeller,crossclassified,2,0,2
15491,farm,sheep,crossclassified,2,0,2
2060,cucumber,pickle,crossclassified,2,1,1
9728,mice,mouse,synonymy,2,0,2
9725,bench,greasepaint,crossclassified,2,2,0
8927,beach,man,crossclassified,2,0,2
9724,bench,woodenware,crossclassified,2,2,0
13009,dugout,sign,crossclassified,2,2,0
9723,bench,chain,crossclassified,2,2,0
12296,car,dash,crossclassified,2,2,0
8421,cap,garage,crossclassified,2,0,2
3918,dock,footbridge,crossclassified,2,2,0
13003,appliance,cabinet,crossclassified,2,0,2
3917,boardwalk,dock,crossclassified,2,0,2
13001,bottle,pot,co-hyponymy,2,2,0
12723,pie,sandwich,crossclassified,2,1,1
446,cake,display,crossclassified,2,2,0
9692,cat,pant,crossclassified,2,2,0
8513,blanket,pillow,crossclassified,2,2,0
15778,legs,skate,crossclassified,2,2,0
250,shirt,straw,crossclassified,2,2,0
3886,biscuit,roll,crossclassified,2,2,0
12732,man,mechanic,crossclassified,2,2,0
9676,cover,hat,crossclassified,2,0,2
9673,lory,truck,crossclassified,2,0,2
3884,fan,woman,crossclassified,2,0,2
9671,egg,sandwich,crossclassified,2,0,2
9667,dress,toll,crossclassified,2,2,0
3696,macaw,parrot,hypernymy.2,2,0,2
8506,motorcycle,rider,crossclassified,2,2,0
8910,car,steel,crossclassified,2,2,0
3879,bed,purse,crossclassified,2,2,0
12322,chair,top,crossclassified,2,2,0
8511,cabinet,chimney,crossclassified,2,2,0
9446,door,hood,crossclassified,2,2,0
14969,girl,skate,crossclassified,2,2,0
2045,cow,leaf,crossclassified,2,2,0
12968,man,ski,crossclassified,2,2,0
8489,desk,fruit,crossclassified,2,2,0
15142,counter,electronic,crossclassified,2,2,0
8917,belt,chair,crossclassified,2,0,2
3894,cart,storage,crossclassified,2,2,0
9690,dress,wall,crossclassified,2,1,1
9687,garage,wheel,crossclassified,2,2,0
9686,box,suit,crossclassified,2,0,2
8915,building,exterior,crossclassified,2,2,0
8477,bench,water,crossclassified,2,2,0
3890,biscuit,donut,crossclassified,2,1,1
12973,dog,hamster,crossclassified,2,0,2
8482,pizza,waffle,crossclassified,2,0,2
9681,bag,curtain,crossclassified,2,0,2
12970,hamster,mammal,hypernymy.2,2,2,0
8485,blazer,tie,crossclassified,2,0,2
9680,man,trouser,crossclassified,2,2,0
9443,door,hatchback,hypernymy.1,2,2,0
9605,dress,truck,crossclassified,2,0,2
14992,rope,truck,crossclassified,2,0,2
8623,headphones,shirt,crossclassified,2,0,2
15120,blanket,building,crossclassified,2,1,1
8750,ramp,rink,crossclassified,2,2,0
12377,shelf,shelve,crossclassified,2,2,0
8754,floor,ramp,crossclassified,2,0,2
9537,shirt,sweet,crossclassified,2,2,0
9536,beer,table,crossclassified,2,0,2
9535,desk,picture,crossclassified,2,2,0
12825,cat,truck,crossclassified,2,0,2
12823,girl,scarf,crossclassified,2,2,0
404,cheese,crust,crossclassified,2,0,2
12822,die,girl,crossclassified,2,0,2
12821,tranche,truck,crossclassified,2,0,2
3377,cow,llama,crossclassified,2,1,1
8765,clothes,woman,crossclassified,2,0,2
9531,airplane,smog,crossclassified,2,2,0
3378,alpaca,llama,hypernymy.2,2,0,2
8838,child,floor,crossclassified,2,2,0
3761,jackknife,knife,hypernymy.2,2,0,2
8747,cake,soup,co-hyponymy,2,0,2
8746,soup,spaghetti,crossclassified,2,2,0
3372,books,chair,crossclassified,2,0,2
9550,rickshaw,vehicle,hypernymy.2,2,0,2
8729,bottle,class,crossclassified,2,2,0
413,automobile,mirror,crossclassified,2,0,2
8732,dish,rice,crossclassified,2,0,2
412,man,scatter,crossclassified,2,2,0
12841,cheese,macaroni,crossclassified,2,2,0
9549,automobile,vehicle,hypernymy.2,2,0,2
12405,bed,cots,hypernymy.1,2,2,0
8736,house,television,crossclassified,2,2,0
3763,house,jeep,crossclassified,2,2,0
12836,candles,table,crossclassified,2,0,2
3727,briefcase,dress,crossclassified,2,0,2
12375,couch,women,crossclassified,2,2,0
263,child,goat,co-hyponymy,2,2,0
9543,cafe,restaurant,hypernymy.2,2,0,2
8836,hat,tree,crossclassified,2,2,0
8771,couch,hall,crossclassified,2,2,0
1838,bus,window,crossclassified,2,2,0
12791,bird,prate,crossclassified,2,2,0
12799,noodles,pan,crossclassified,2,0,2
9503,ramp,snow,crossclassified,2,0,2
8806,desk,telephone,crossclassified,2,2,0
9488,umbrella,van,crossclassified,2,0,2
3737,fence,train,crossclassified,2,0,2
9489,cat,door,crossclassified,2,0,2
9497,surfer,swimmer,hypernymy.2,2,2,0
9495,clothing,jersey,hypernymy.1,2,0,2
3393,craft,vase,crossclassified,2,0,2
9494,calico,cat,crossclassified,2,0,2
8820,pizza,rice,crossclassified,2,1,1
9492,counter,lid,crossclassified,2,2,0
8822,rice,vegetable,crossclassified,2,2,0
3734,boat,skiff,hypernymy.1,2,2,0
12785,couch,photo,crossclassified,2,2,0
15021,curtain,tub,crossclassified,2,2,0
9504,snow,snowmobile,crossclassified,2,2,0
12395,desk,light,crossclassified,2,2,0
275,lettuce,spinach,crossclassified,2,2,0
2000,bellow,bench,crossclassified,2,0,2
8776,couch,mom,crossclassified,2,2,0
3750,bird,crew,crossclassified,2,2,0
12385,futon,sofa,crossclassified,2,2,0
12386,futon,net,crossclassified,2,2,0
274,greens,lettuce,hypernymy.1,2,0,2
9518,horse,person,crossclassified,2,2,0
9517,sink,stand,crossclassified,2,2,0
12403,cat,van,crossclassified,2,0,2
9515,couple,tuxedo,crossclassified,2,2,0
9514,couple,groom,crossclassified,2,2,0
12390,coke,table,crossclassified,2,0,2
401,crust,utensils,crossclassified,2,2,0
12806,man,teammate,crossclassified,2,2,0
9487,car,reflection,crossclassified,2,2,0
9512,clothing,couple,crossclassified,2,0,2
3726,dress,luggage,crossclassified,2,2,0
8726,device,phone,hypernymy.1,2,1,1
8870,bear,bed,crossclassified,2,0,2
15000,shore,tree,crossclassified,2,2,0
9470,cup,pottery,crossclassified,2,2,0
8656,belt,truck,crossclassified,2,0,2
1833,man,mirror,crossclassified,2,2,0
9583,caretaker,man,crossclassified,2,0,2
9582,knife,pan,crossclassified,2,0,2
2015,dugout,glove,crossclassified,2,2,0
12881,plat,wheelchair,crossclassified,2,0,2
8669,bad,floor,crossclassified,2,0,2
8678,people,train,crossclassified,2,0,2
9574,bird,fields,crossclassified,2,2,0
9573,bird,chain,crossclassified,2,2,0
8861,kid,laptop,crossclassified,2,0,2
9571,male,shirt,crossclassified,2,0,2
15025,goal,stand,crossclassified,2,2,0
12869,teepee,tip,crossclassified,2,2,0
8677,person,train,crossclassified,2,0,2
8654,bridge,lamp,crossclassified,2,2,0
9586,die,shirt,crossclassified,2,0,2
12759,building,man,crossclassified,2,2,0
3349,couch,sleeveless,crossclassified,2,2,0
8869,bed,bible,crossclassified,2,2,0
3809,jacket,outerwear,crossclassified,2,2,0
12757,building,family,crossclassified,2,2,0
3805,child,hitter,crossclassified,2,2,0
9601,cabinet,shoe,crossclassified,2,2,0
15527,backpack,bench,crossclassified,2,2,0
3403,food,veggies,hypernymy.1,2,2,0
9595,hose,water,crossclassified,2,2,0
12412,parachute,skydiver,crossclassified,2,2,0
8642,house,luggage,crossclassified,2,2,0
12890,shirt,shirtmaker,crossclassified,2,2,0
3797,automobile,man,crossclassified,2,0,2
12888,bracelet,jacket,crossclassified,2,0,2
9588,cat,puppy,crossclassified,2,2,0
8864,child,laptop,crossclassified,2,0,2
396,crust,spatula,crossclassified,2,2,0
1836,pizza,wooden,crossclassified,2,2,0
3768,cart,wheelchair,crossclassified,2,0,2
8714,dish,spoon,co-hyponymy,2,0,2
8706,surfer,watch,crossclassified,2,2,0
12853,head,house,crossclassified,2,0,2
9477,cup,strainer,crossclassified,2,2,0
8709,chair,luggage,crossclassified,2,2,0
8710,tree,wood,crossclassified,2,2,0
9557,desk,hardware,crossclassified,2,2,0
8712,tree,trunks,crossclassified,2,2,0
12849,frisbee,person,crossclassified,2,0,2
3782,jacket,wall,crossclassified,2,1,1
9554,boat,bud,crossclassified,2,2,0
9553,auto,vehicle,hypernymy.2,2,0,2
12770,shirt,toilet,crossclassified,2,2,0
8720,cat,vase,crossclassified,2,2,0
8846,bottle,vial,hypernymy.1,2,2,0
8723,truck,water,crossclassified,2,2,0
3769,luggage,wheelchair,crossclassified,2,0,2
8705,foil,pan,crossclassified,2,0,2
8704,oven,pan,crossclassified,2,0,2
15005,ground,shore,crossclassified,2,0,2
9560,man,shoo,crossclassified,2,2,0
3399,beach,chair,crossclassified,2,1,1
3781,backstop,wall,co-hyponymy,2,0,2
8683,barer,pizza,crossclassified,2,0,2
9569,burger,fruit,crossclassified,2,2,0
12765,restaurant,umbrella,crossclassified,2,2,0
3722,girl,tree,crossclassified,2,2,0
8685,casserole,pizza,co-hyponymy,2,0,2
8686,suit,wall,crossclassified,2,2,0
12864,pie,quiche,hypernymy.1,2,2,0
8851,dress,umbellate,crossclassified,2,2,0
3363,animal,squirrel,hypernymy.1,2,0,2
12860,bench,sign,crossclassified,2,1,1
8697,bur,hotdog,crossclassified,2,0,2
3777,padding,wall,crossclassified,2,0,2
3776,backboard,wall,crossclassified,2,0,2
9731,suit,sweater,co-hyponymy,2,0,2
1771,table,vent,crossclassified,2,2,0
9434,building,men,crossclassified,2,2,0
4075,restaurant,truck,crossclassified,2,0,2
15173,burger,couch,crossclassified,2,0,2
8121,light,shirt,crossclassified,2,0,2
9900,knife,phone,crossclassified,2,2,0
15172,couch,foods,crossclassified,2,2,0
8124,child,jug,crossclassified,2,2,0
2079,dugout,uniform,crossclassified,2,2,0
12667,feet,floor,crossclassified,2,0,2
12668,floor,group,hypernymy.2,2,2,0
8132,shirt,water,crossclassified,2,2,0
13161,vase,vessel,hypernymy.2,2,2,0
14897,costume,girl,crossclassified,2,0,2
12669,chair,dresser,crossclassified,2,1,1
1981,boy,screen,crossclassified,2,2,0
8129,toilet,westernization,crossclassified,2,2,0
15785,goalkeeper,man,crossclassified,2,0,2
9393,book,cake,crossclassified,2,0,2
15786,bench,dogs,crossclassified,2,2,0
14895,elephant,head,crossclassified,2,2,0
14894,elephant,face,crossclassified,2,2,0
3189,court,dress,crossclassified,2,1,1
13180,suit,watch,crossclassified,2,2,0
8096,vent,ventilator,crossclassified,2,2,0
12664,food,veritable,crossclassified,2,2,0
3183,court,shoe,crossclassified,2,2,0
13177,eyeglass,face,crossclassified,2,0,2
8100,ground,pizza,crossclassified,2,0,2
13174,boy,fan,crossclassified,2,2,0
8105,girl,sleeveless,crossclassified,2,2,0
1884,skier,suffocating,crossclassified,2,2,0
4085,lamp,sheep,crossclassified,2,0,2
8108,food,produce,hypernymy.1,2,2,0
9019,blate,dog,crossclassified,2,0,2
1714,body,woman,crossclassified,2,0,2
3188,court,turf,crossclassified,2,2,0
8115,bench,cabinet,crossclassified,2,1,1
2078,guys,man,hypernymy.2,2,0,2
9894,building,furniture,crossclassified,2,2,0
8092,pole,vent,crossclassified,2,0,2
4050,candy,donut,crossclassified,2,0,2
9876,lamp,tree,crossclassified,2,2,0
9875,boy,lady,crossclassified,2,2,0
13139,hotdog,pickles,crossclassified,2,2,0
8171,coat,train,crossclassified,2,0,2
8172,entrance,train,crossclassified,2,0,2
4053,cat,leopard,hypernymy.1,2,2,0
12219,counter,veg,crossclassified,2,2,0
12456,bench,pigeons,crossclassified,2,2,0
9893,building,chairs,crossclassified,2,2,0
8180,blender,grinder,crossclassified,2,2,0
9862,dress,sweatshirt,crossclassified,2,1,1
9860,spoons,woman,crossclassified,2,0,2
1982,cheese,spoon,crossclassified,2,0,2
9858,sauce,yolk,crossclassified,2,2,0
12228,flatbed,train,crossclassified,2,0,2
8195,cat,girl,co-hyponymy,2,0,2
8165,shelf,window,crossclassified,2,2,0
14903,fess,shirt,crossclassified,2,0,2
8163,caribou,cow,crossclassified,2,0,2
12215,boat,dinghy,hypernymy.1,2,2,0
9892,rug,wire,crossclassified,2,2,0
8137,vase,woman,crossclassified,2,0,2
8138,donut,sprinkle,crossclassified,2,2,0
8139,donut,muffin,crossclassified,2,1,1
4070,bagel,pizza,crossclassified,2,1,1
3196,cycle,floor,crossclassified,2,0,2
8143,cake,dish,hypernymy.2,2,2,0
4068,pizza,seafood,crossclassified,2,2,0
4067,pancake,pizza,crossclassified,2,1,1
9887,boat,city,crossclassified,2,2,0
13150,dip,guacamole,hypernymy.1,2,0,2
13149,cat,sweatshirt,crossclassified,2,0,2
4064,cupboard,refrigerator,crossclassified,2,0,2
9883,bed,cupboard,crossclassified,2,2,0
1729,building,road,crossclassified,2,1,1
9382,puddle,water,hypernymy.2,2,0,2
8091,cow,mother,crossclassified,2,2,0
8197,food,fritter,hypernymy.1,2,2,0
3166,sandwich,sneaks,crossclassified,2,2,0
12469,counter,doughnuts,crossclassified,2,2,0
8024,pants,rug,crossclassified,2,0,2
14875,clock,seat,crossclassified,2,2,0
3629,table,unknown,crossclassified,2,2,0
1682,court,skier,crossclassified,2,0,2
12651,bedpost,floor,crossclassified,2,0,2
14876,bed,clock,crossclassified,2,0,2
8031,cabinets,drawers,crossclassified,2,2,0
4125,design,vase,crossclassified,2,0,2
8032,cabinets,cupboards,crossclassified,2,2,0
4137,man,stove,crossclassified,2,2,0
8034,cabinets,furniture,hypernymy.2,2,2,0
9041,couch,umbrella,crossclassified,2,2,0
4133,couch,hat,crossclassified,2,2,0
14877,clock,cushion,crossclassified,2,2,0
15513,bunked,ladder,crossclassified,2,2,0
12784,bear,couch,crossclassified,2,0,2
12171,dog,vehicle,crossclassified,2,2,0
13217,pitcher,teapot,crossclassified,2,0,2
13218,jug,teapot,crossclassified,2,0,2
3147,children,couch,crossclassified,2,0,2
9051,plush,toy,crossclassified,2,0,2
9966,house,pagoda,crossclassified,2,2,0
3626,girl,swimmer,crossclassified,2,2,0
12163,sofa,wood,crossclassified,2,2,0
8000,child,knife,crossclassified,2,2,0
4148,bird,sand,crossclassified,2,2,0
13224,knife,quesadilla,crossclassified,2,2,0
9048,lion,toy,crossclassified,2,0,2
8005,shirt,surfboard,crossclassified,2,2,0
8007,counter,mug,crossclassified,2,2,0
12169,couch,head,crossclassified,2,2,0
4145,employee,man,crossclassified,2,0,2
9955,dress,pillow,crossclassified,2,2,0
8013,helmet,sidecar,crossclassified,2,0,2
9371,chair,clothes,crossclassified,2,2,0
12178,clothing,motorcycle,crossclassified,2,0,2
9024,shirty,woman,crossclassified,2,0,2
13184,cake,coconut,crossclassified,2,2,0
9926,samosa,table,crossclassified,2,0,2
3179,cupcake,toy,crossclassified,2,2,0
9378,boy,patient,crossclassified,2,2,0
12659,bottle,dresser,crossclassified,2,0,2
9919,cookie,desert,crossclassified,2,2,0
3180,cupcake,doll,crossclassified,2,2,0
4105,avocado,pizza,crossclassified,2,0,2
8082,iron,train,crossclassified,2,0,2
13202,bridge,surfboard,crossclassified,2,2,0
1885,trailers,truck,crossclassified,2,0,2
12190,curtain,frog,crossclassified,2,2,0
9381,dog,water,crossclassified,2,0,2
15176,dolls,toy,hypernymy.2,2,0,2
4097,paper,wrapper,crossclassified,2,0,2
8088,coke,donut,crossclassified,2,0,2
13181,giraffe,zoo,crossclassified,2,2,0
9927,desert,jacket,crossclassified,2,0,2
9928,jacket,poncho,crossclassified,2,2,0
8064,jacket,painting,crossclassified,2,2,0
8063,graffiti,jacket,crossclassified,2,0,2
9938,hose,pipe,co-hyponymy,2,2,0
12179,motorcycle,toddler,crossclassified,2,2,0
9936,hose,truck,crossclassified,2,2,0
8050,short,skateboarder,crossclassified,2,0,2
3449,animal,jacket,crossclassified,2,0,2
511,skier,sweater,crossclassified,2,2,0
4123,dog,vase,crossclassified,2,1,1
8055,butter,salad,crossclassified,2,0,2
9376,baseballs,dugout,crossclassified,2,0,2
224,face,horse,crossclassified,2,0,2
9033,boat,home,crossclassified,2,2,0
4120,car,floor,crossclassified,2,1,1
3174,bird,shadow,crossclassified,2,2,0
9930,counter,snakes,crossclassified,2,2,0
8062,donut,rice,crossclassified,2,1,1
12229,eyeglass,table,crossclassified,2,0,2
8998,rake,table,crossclassified,2,0,2
3928,rail,tracks,synonymy,2,0,2
1987,frock,shirt,crossclassified,2,0,2
3960,gloves,snowboarder,crossclassified,2,0,2
8338,curtain,hands,crossclassified,2,2,0
8340,jets,plane,hypernymy.2,2,0,2
12705,cab,house,crossclassified,2,0,2
8342,food,hash,hypernymy.1,2,2,0
12708,cow,wildebeest,crossclassified,2,2,0
1985,couch,leaf,crossclassified,2,2,0
3246,steak,table,crossclassified,2,0,2
3250,hotdog,taco,crossclassified,2,2,0
3953,cat,face,crossclassified,2,2,0
12275,car,ford,crossclassified,2,2,0
8349,carpet,umbrella,crossclassified,2,2,0
8350,net,shirt,crossclassified,2,0,2
9427,celery,vegetable,hypernymy.2,2,0,2
3248,bowl,pottery,crossclassified,2,2,0
3949,bear,water,crossclassified,2,0,2
9773,cat,spoon,crossclassified,2,2,0
9774,bus,woman,crossclassified,2,0,2
13051,ceiling,roof,synonymy,2,0,2
9777,chair,shower,crossclassified,2,2,0
9794,cereal,yogurt,crossclassified,2,2,0
8307,fresh,woman,crossclassified,2,0,2
12260,skirting,table,crossclassified,2,0,2
8951,broccoli,meal,crossclassified,2,2,0
8311,airplane,relic,crossclassified,2,2,0
3242,container,reservoir,hypernymy.1,2,2,0
3972,dad,shirt,crossclassified,2,0,2
12265,belt,motorcycle,crossclassified,2,0,2
13055,roof,umbrella,crossclassified,2,2,0
3431,bike,cat,crossclassified,2,0,2
9782,plates,table,crossclassified,2,0,2
9781,shirt,yid,crossclassified,2,2,0
3963,bread,slice,crossclassified,2,2,0
9778,pat,woman,crossclassified,2,0,2
8327,ship,woman,crossclassified,2,0,2
8353,boy,runner,crossclassified,2,2,0
1763,bandana,man,crossclassified,2,0,2
8304,counter,washermen,crossclassified,2,2,0
8393,cup,pushpin,crossclassified,2,2,0
13026,horse,hours,crossclassified,2,2,0
13025,coffee,drink,hypernymy.2,2,0,2
13024,bathtub,washingtonian,crossclassified,2,2,0
12718,chair,ta,crossclassified,2,2,0
8390,cub,giraffe,crossclassified,2,0,2
8392,tail,wing,crossclassified,2,0,2
9433,building,bushes,crossclassified,2,2,0
8931,shoe,skating,crossclassified,2,2,0
3252,mug,soup,crossclassified,2,0,2
9743,desk,sunglasses,crossclassified,2,2,0
13021,arm,sweatshirt,crossclassified,2,0,2
9741,man,shopper,crossclassified,2,2,0
12289,motorcycle,motorcycling,crossclassified,2,2,0
8399,donut,pancake,crossclassified,2,2,0
9739,bed,girls,crossclassified,2,2,0
9737,bed,teacup,crossclassified,2,2,0
3265,candle,woman,crossclassified,2,0,2
14945,garage,sheds,co-hyponymy,2,2,0
3933,boat,surfer,crossclassified,2,0,2
8934,ramp,scatting,crossclassified,2,2,0
8359,boy,glove,crossclassified,2,2,0
3255,boarder,snowboarder,crossclassified,2,0,2
13035,bracelet,man,crossclassified,2,0,2
9755,cookie,pastry,crossclassified,2,2,0
2063,cucumber,fruit,crossclassified,2,2,0
12716,bench,chi,crossclassified,2,2,0
8371,beans,rice,crossclassified,2,0,2
9751,book,dress,crossclassified,2,0,2
8373,pant,scooter,crossclassified,2,0,2
13029,carriage,wheel,co-hyponymy,2,2,0
8935,pant,ramp,crossclassified,2,0,2
3937,bridge,table,crossclassified,2,1,1
3936,bridge,post,crossclassified,2,2,0
8378,hawaiian,shirt,crossclassified,2,0,2
2062,cucumber,produce,hypernymy.2,2,2,0
9421,floor,keyboard,crossclassified,2,2,0
1755,hotdog,topping,crossclassified,2,2,0
4035,cloth,tablecloth,crossclassified,2,0,2
1870,brat,sandwich,crossclassified,2,0,2
2074,jacket,juice,crossclassified,2,2,0
8229,egg,taco,crossclassified,2,0,2
13104,banana,pot,crossclassified,2,0,2
12240,car,fence,crossclassified,2,2,0
8236,bag,horse,crossclassified,2,0,2
3667,house,trailer,crossclassified,2,2,0
15518,beat,chair,crossclassified,2,0,2
15105,boat,book,crossclassified,2,2,0
8249,handbag,table,crossclassified,2,0,2
12693,cloth,table,crossclassified,2,0,2
13099,bag,tent,crossclassified,2,0,2
1746,gravy,liquid,crossclassified,2,2,0
8244,man,suspender,crossclassified,2,2,0
12694,curtain,player,crossclassified,2,2,0
12695,curtain,racket,crossclassified,2,2,0
3222,bench,sparrow,crossclassified,2,2,0
9836,man,platform,crossclassified,2,2,0
3661,cupcake,pastry,crossclassified,2,2,0
4611,harness,vest,crossclassified,2,0,2
12687,bench,gate,crossclassified,2,2,0
8202,livestock,sheep,crossclassified,2,0,2
4032,goat,truck,crossclassified,2,0,2
8997,phone,pizza,crossclassified,2,0,2
15492,man,sharia,crossclassified,2,2,0
9846,cap,curtain,crossclassified,2,0,2
8214,airings,woman,crossclassified,2,0,2
15516,bench,jackets,crossclassified,2,2,0
13114,bouquet,table,crossclassified,2,0,2
9844,shirt,waistcoat,co-hyponymy,2,2,0
12683,bed,teddy,crossclassified,2,2,0
13113,hat,teddy,crossclassified,2,2,0
8219,bench,birds,crossclassified,2,2,0
13111,dugout,table,crossclassified,2,2,0
8984,airplane,wins,crossclassified,2,2,0
9841,facade,house,crossclassified,2,0,2
9823,ball,ground,crossclassified,2,0,2
13093,house,housing,hypernymy.2,2,2,0
13065,computer,woman,crossclassified,2,0,2
1865,bridge,pillar,co-hyponymy,2,2,0
8281,bookshelf,head,crossclassified,2,2,0
9804,child,towel,crossclassified,2,2,0
12254,couch,suit,crossclassified,2,2,0
3977,refrigerator,wine,crossclassified,2,2,0
378,arm,girl,crossclassified,2,0,2
15520,boy,sharia,crossclassified,2,2,0
13073,bed,cup,crossclassified,2,2,0
13070,hooves,horse,crossclassified,2,0,2
1748,burger,gravy,crossclassified,2,0,2
15156,cowboy,tent,crossclassified,2,0,2
8295,castle,house,hypernymy.2,2,1,1
9796,donut,pastries,crossclassified,2,2,0
8298,boom,carpet,crossclassified,2,0,2
8953,boat,cake,crossclassified,2,1,1
8300,horse,race,crossclassified,2,2,0
13066,woman,yard,crossclassified,2,2,0
13078,plastic,table,crossclassified,2,0,2
8959,blt,shirt,crossclassified,2,0,2
9416,boat,hull,crossclassified,2,2,0
3232,counter,pie,crossclassified,2,2,0
3224,ban,bread,crossclassified,2,0,2
8254,boat,people,crossclassified,2,2,0
9411,bench,outfit,crossclassified,2,2,0
3226,reckless,shirt,crossclassified,2,0,2
8257,fries,hotdog,crossclassified,2,0,2
3989,eye,hat,crossclassified,2,0,2
9815,dress,glass,crossclassified,2,2,0
8264,bench,kiwi,crossclassified,2,2,0
14924,bans,boy,crossclassified,2,0,2
13086,board,surfboard,hypernymy.1,2,0,2
8966,bucket,glass,co-hyponymy,2,2,0
3231,person,suit,hypernymy.1,2,0,2
3682,bread,soup,crossclassified,2,0,2
13083,oven,rack,crossclassified,2,0,2
8271,basket,hotdog,crossclassified,2,0,2
7172,cat,watch,crossclassified,2,2,0
5546,house,photo,crossclassified,2,2,0
10424,counter,gas,crossclassified,2,2,0
13987,dessert,sandwich,crossclassified,2,0,2
15299,bookshelf,cap,crossclassified,2,2,0
10907,curtain,wallpaper,crossclassified,2,2,0
6309,clothing,snowboarder,crossclassified,2,0,2
11599,truck,wheeler,crossclassified,2,2,0
15297,house,lamp,crossclassified,2,2,0
2660,cutlet,food,crossclassified,2,0,2
5088,decoration,horse,crossclassified,2,0,2
6315,beach,motorcycle,crossclassified,2,0,2
6316,human,motorcycle,crossclassified,2,0,2
6318,bridge,tower,co-hyponymy,2,2,0
15631,giraffe,paraffin,crossclassified,2,2,0
10900,animal,floor,crossclassified,2,0,2
14540,floor,stage,crossclassified,2,2,0
5079,bikes,truck,co-hyponymy,2,0,2
2662,athletes,woman,crossclassified,2,0,2
6332,gran,woman,crossclassified,2,0,2
6334,counter,storage,crossclassified,2,2,0
10910,notebook,table,crossclassified,2,0,2
5093,jacket,necklace,crossclassified,2,2,0
6301,boy,shoes,crossclassified,2,2,0
1341,sideboard,table,co-hyponymy,2,0,2
959,doughnuts,shirt,crossclassified,2,0,2
10929,bear,girl,crossclassified,2,1,1
14526,dugout,roof,crossclassified,2,2,0
2329,bed,linen,crossclassified,2,2,0
2649,dress,strap,crossclassified,2,2,0
6275,couple,newlyweds,crossclassified,2,2,0
10923,glass,smoothie,crossclassified,2,2,0
6280,boot,table,crossclassified,2,0,2
6298,sea,wave,crossclassified,2,0,2
5103,ashtray,table,crossclassified,2,0,2
6286,cloth,coat,crossclassified,2,0,2
11593,boat,shell,hypernymy.1,2,2,0
6292,hazmat,man,crossclassified,2,0,2
14042,elephant,hut,crossclassified,2,0,2
10916,apple,couch,crossclassified,2,0,2
10914,tin,train,crossclassified,2,0,2
6335,bathtub,wall,crossclassified,2,2,0
2324,child,controller,co-hyponymy,2,2,0
6337,swim,woman,crossclassified,2,0,2
6399,bouquet,flower,crossclassified,2,0,2
5044,beach,walkway,crossclassified,2,2,0
1354,blanket,cape,crossclassified,2,1,1
1355,cape,gown,crossclassified,2,1,1
951,marina,water,crossclassified,2,2,0
11629,floor,ropes,crossclassified,2,2,0
6396,bun,toppings,crossclassified,2,2,0
13992,cushion,table,crossclassified,2,0,2
10858,cat,pot,crossclassified,2,0,2
13997,building,stone,crossclassified,2,2,0
6402,horse,water,crossclassified,2,2,0
950,marina,village,crossclassified,2,2,0
2687,cookware,counter,crossclassified,2,0,2
5035,back,woman,crossclassified,2,0,2
10853,desk,plat,crossclassified,2,2,0
10852,coat,tent,crossclassified,2,0,2
10851,tent,tie,crossclassified,2,2,0
6390,food,lime,hypernymy.1,2,1,1
10861,cotton,sheep,crossclassified,2,0,2
6339,pastry,table,crossclassified,2,0,2
14545,man,sitting,crossclassified,2,2,0
14542,glass,knife,crossclassified,2,0,2
6342,glass,lemons,crossclassified,2,2,0
6346,bowl,desk,crossclassified,2,1,1
14017,paper,ruler,crossclassified,2,0,2
6351,bridge,trafficking,crossclassified,2,2,0
15401,building,cloth,crossclassified,2,2,0
5067,bathrooms,curtain,crossclassified,2,0,2
10879,doughnut,dugout,crossclassified,2,0,2
5047,beach,pier,crossclassified,2,2,0
14010,balcony,house,crossclassified,2,0,2
14552,chain,man,crossclassified,2,0,2
5051,beach,seat,crossclassified,2,2,0
6380,bowl,foot,crossclassified,2,2,0
2313,airplanes,airport,crossclassified,2,0,2
10864,bathtub,washstand,crossclassified,2,2,0
6385,female,man,co-hyponymy,2,0,2
6267,bench,socks,crossclassified,2,2,0
10931,counter,fruits,crossclassified,2,2,0
11585,aquarium,pillow,crossclassified,2,2,0
2342,light,man,crossclassified,2,0,2
5194,airplane,wheels,crossclassified,2,2,0
11001,boat,fence,crossclassified,2,2,0
10999,boat,gate,crossclassified,2,2,0
2343,general,man,hypernymy.2,2,0,2
14100,carpet,heels,crossclassified,2,2,0
15315,train,wheels,crossclassified,2,2,0
6161,commuter,man,crossclassified,2,0,2
14096,horse,nose,crossclassified,2,2,0
6145,bag,person,hypernymy.2,2,0,2
14095,horse,snout,crossclassified,2,2,0
5181,haircut,woman,crossclassified,2,0,2
6167,food,samosas,hypernymy.1,2,2,0
2619,tailgate,truck,crossclassified,2,0,2
2620,fender,truck,crossclassified,2,0,2
11548,boat,watermelon,crossclassified,2,2,0
6180,shelter,umbrella,hypernymy.1,2,0,2
11003,floor,flowerpot,crossclassified,2,2,0
2608,bentonite,food,crossclassified,2,0,2
14083,bucket,canister,crossclassified,2,0,2
6129,scatting,skier,crossclassified,2,0,2
5207,cot,crib,synonymy,2,0,2
11528,clock,van,crossclassified,2,0,2
14118,canisters,table,crossclassified,2,0,2
6120,blanket,dog,crossclassified,2,0,2
14115,rail,skateboard,crossclassified,2,2,0
6127,men,skier,crossclassified,2,0,2
6128,female,skier,crossclassified,2,0,2
11010,camera,screen,crossclassified,2,2,0
6143,jacket,kerchief,crossclassified,2,2,0
6132,person,wineglass,crossclassified,2,2,0
6135,apple,pie,crossclassified,2,1,1
6138,apple,bed,crossclassified,2,1,1
2344,board,desk,crossclassified,2,0,2
11005,floor,man,crossclassified,2,1,1
5197,jacket,keyboard,crossclassified,2,2,0
14107,rail,ramp,crossclassified,2,2,0
11551,electronics,person,crossclassified,2,0,2
14505,desk,notes,crossclassified,2,2,0
6258,cap,mound,crossclassified,2,0,2
15304,robe,suit,co-hyponymy,2,2,0
1332,food,potatoes,hypernymy.1,2,2,0
6232,human,leg,crossclassified,2,0,2
14061,bucket,stump,crossclassified,2,0,2
11571,pot,saucepan,crossclassified,2,2,0
6237,men,woman,co-hyponymy,2,0,2
6239,drink,soup,crossclassified,2,0,2
10948,furniture,island,crossclassified,2,0,2
6245,airplane,pal,crossclassified,2,2,0
14063,pot,stump,crossclassified,2,0,2
14054,butter,sauce,crossclassified,2,0,2
6250,dress,vehicle,crossclassified,2,2,0
11579,card,table,crossclassified,2,0,2
11581,ban,boy,crossclassified,2,0,2
2640,condiments,table,crossclassified,2,0,2
6255,field,mound,crossclassified,2,0,2
10937,mixer,table,crossclassified,2,0,2
6227,boy,camera,crossclassified,2,2,0
11568,rug,window,crossclassified,2,2,0
10976,spoon,straw,crossclassified,2,2,0
6210,cab,man,crossclassified,2,0,2
11555,pillow,table,crossclassified,2,0,2
14079,frisbee,t-shirt,crossclassified,2,2,0
11558,bridge,dress,crossclassified,2,2,0
970,cups,table,crossclassified,2,0,2
10970,counter,knob,crossclassified,2,2,0
10966,house,pool,crossclassified,2,2,0
14513,lamp,man,crossclassified,2,0,2
2336,couples,man,crossclassified,2,0,2
14065,bear,stump,crossclassified,2,0,2
2633,bird,cock,hypernymy.1,2,2,0
1326,bridge,signboard,co-hyponymy,2,2,0
5149,glove,jacket,crossclassified,2,1,1
2634,bird,grackle,hypernymy.1,2,2,0
6218,bench,grill,crossclassified,2,2,0
6219,surfer,women,crossclassified,2,2,0
1331,food,sauerkraut,hypernymy.1,2,2,0
6411,shoulders,suit,crossclassified,2,0,2
6413,basket,vase,crossclassified,2,0,2
6112,human,player,crossclassified,2,0,2
5034,seatbelt,shirt,crossclassified,2,0,2
6578,culture,giraffe,crossclassified,2,0,2
6579,giraffe,ornament,crossclassified,2,2,0
11674,backpack,girl,crossclassified,2,0,2
11675,cop,motorcycle,crossclassified,2,0,2
6584,animals,zebra,hypernymy.1,2,0,2
902,bread,flatbread,hypernymy.1,2,2,0
11677,building,dress,crossclassified,2,2,0
10762,device,drive,hypernymy.1,2,2,0
4929,cub,shirt,crossclassified,2,0,2
6590,dumpster,truck,crossclassified,2,0,2
10761,adapter,device,hypernymy.2,2,0,2
13908,bottle,t-shirt,crossclassified,2,1,1
1384,flamingo,swan,crossclassified,2,2,0
10759,controller,device,hypernymy.2,2,0,2
4924,moot,motorcycle,crossclassified,2,0,2
901,animal,goose,hypernymy.1,2,0,2
13906,bird,cage,crossclassified,2,2,0
11672,kid,tie,crossclassified,2,0,2
10770,display,flowers,crossclassified,2,0,2
1380,sneaks,table,crossclassified,2,0,2
15411,bowl,man,crossclassified,2,0,2
4953,portrait,queen,crossclassified,2,0,2
4951,person,queen,hypernymy.1,2,0,2
2731,cup,jacket,crossclassified,2,0,2
906,hydrant,red,crossclassified,2,2,0
6549,hiker,woman,crossclassified,2,0,2
11668,bear,man,crossclassified,2,1,1
6553,bards,bird,crossclassified,2,0,2
14587,blazer,shirt,crossclassified,2,0,2
6572,condiments,relish,hypernymy.1,2,0,2
6559,bowl,train,crossclassified,2,0,2
6561,floor,grate,crossclassified,2,0,2
6562,bike,grate,crossclassified,2,0,2
6564,grate,mat,crossclassified,2,2,0
6565,grate,grating,synonymy,2,2,0
4941,can,soda,crossclassified,2,2,0
4940,beer,can,crossclassified,2,0,2
10758,device,hardcover,crossclassified,2,2,0
13904,box,girl,crossclassified,2,0,2
10756,device,laptop,hypernymy.1,2,2,0
11706,motorcycle,truck,co-hyponymy,2,2,0
6651,child,cloth,crossclassified,2,2,0
10724,cup,steel,crossclassified,2,2,0
4894,man,skateboarding,crossclassified,2,2,0
6657,bed,bunks,hypernymy.1,2,2,0
6659,bed,rail,crossclassified,2,2,0
6660,cleaner,woman,hypernymy.1,2,0,2
11705,motorcycle,pole,crossclassified,2,2,0
11707,glass,lamp,crossclassified,2,1,1
13877,dog,snow,crossclassified,2,2,0
15619,counter,train,crossclassified,2,2,0
11708,boy,fresh,crossclassified,2,2,0
6671,cow,udder,crossclassified,2,2,0
10711,desk,switcher,crossclassified,2,2,0
4878,batter,dress,crossclassified,2,2,0
6674,batter,kid,crossclassified,2,2,0
2759,coat,handbag,crossclassified,2,2,0
6650,child,gamer,crossclassified,2,2,0
13879,snow,woman,crossclassified,2,0,2
11684,cabinet,display,crossclassified,2,2,0
2272,building,ladder,crossclassified,2,2,0
11685,floor,pole,crossclassified,2,2,0
6612,corset,dress,crossclassified,2,0,2
11686,cookbook,table,crossclassified,2,0,2
6616,toy,truck,crossclassified,2,0,2
11689,counter,cups,crossclassified,2,2,0
2741,bird,grass,crossclassified,2,2,0
2743,coat,dog,crossclassified,2,1,1
4914,sportsman,woman,crossclassified,2,0,2
10732,surfer,top,crossclassified,2,2,0
10739,cat,clothing,crossclassified,2,2,0
14597,television,vase,crossclassified,2,0,2
6629,cab,skier,crossclassified,2,0,2
13887,defender,man,crossclassified,2,0,2
11693,counter,machine,hypernymy.2,2,2,0
13885,teeth,zebra,crossclassified,2,0,2
4907,bowl,dog,crossclassified,2,0,2
11664,board,counter,crossclassified,2,0,2
6539,child,goggles,crossclassified,2,2,0
2728,bassinet,bed,crossclassified,2,0,2
6461,man,sportsman,crossclassified,2,2,0
6449,headgear,turban,hypernymy.1,2,0,2
6451,phone,turban,crossclassified,2,0,2
6452,electronics,turban,crossclassified,2,0,2
13966,blanket,sheet,crossclassified,2,2,0
5018,pot,stove,crossclassified,2,1,1
5017,stove,vessels,crossclassified,2,2,0
11640,floor,oven,crossclassified,2,0,2
5015,range,stove,synonymy,2,0,2
937,counter,range,crossclassified,2,2,0
6463,dress,jumper,hypernymy.1,2,2,0
11641,mat,oven,crossclassified,2,0,2
6466,boy,bracelet,crossclassified,2,2,0
6467,cat,tabby,hypernymy.1,2,2,0
15707,bench,ottoman,co-hyponymy,2,0,2
5013,crape,food,hypernymy.2,2,0,2
1359,cape,t-shirt,crossclassified,2,2,0
5020,fence,woman,crossclassified,2,0,2
10833,boy,legs,crossclassified,2,0,2
5006,laptop,sink,crossclassified,2,0,2
10843,airplane,mirror,crossclassified,2,2,0
11632,oven,wood,crossclassified,2,2,0
6417,shirt,shirting,crossclassified,2,2,0
2309,airport,hanger,crossclassified,2,2,0
10847,building,signboard,co-hyponymy,2,2,0
6420,container,salad,crossclassified,2,0,2
11633,laptop,oven,crossclassified,2,0,2
2308,airfield,airport,hypernymy.1,2,0,2
6429,shirt,umpire,crossclassified,2,0,2
6444,chest,jacket,crossclassified,2,0,2
13976,bench,vest,crossclassified,2,2,0
10838,person,sunglasses,crossclassified,2,2,0
10837,eyeglass,person,crossclassified,2,0,2
6436,guacamole,pizza,crossclassified,2,2,0
6439,avocado,guacamole,crossclassified,2,0,2
6440,guacamole,relish,crossclassified,2,2,0
13971,bird,man,crossclassified,2,1,1
14564,table,tail,crossclassified,2,2,0
11645,surfer,third,crossclassified,2,2,0
6537,apple,jacket,crossclassified,2,0,2
1368,kale,salad,crossclassified,2,0,2
13938,cinderella,gown,crossclassified,2,2,0
1364,jacket,student,crossclassified,2,2,0
4977,building,van,crossclassified,2,2,0
10799,car,wood,crossclassified,2,2,0
4973,clock,train,crossclassified,2,0,2
2294,croissant,plate,crossclassified,2,2,0
2289,ballplayer,table,crossclassified,2,0,2
6522,bread,jacket,crossclassified,2,0,2
2714,plat,sandwich,crossclassified,2,0,2
2288,basket,giraffe,crossclassified,2,0,2
2284,jacket,teddy,crossclassified,2,2,0
10790,cupboards,kitchen,crossclassified,2,0,2
6529,skier,tree,crossclassified,2,2,0
4962,bucket,wastebasket,crossclassified,2,2,0
4959,flames,shirt,crossclassified,2,0,2
14582,mirror,vase,crossclassified,2,0,2
13939,cartoon,cinderella,crossclassified,2,0,2
4982,meat,pork,hypernymy.1,2,2,0
10819,grass,t-shirt,crossclassified,2,2,0
6489,fence,sidewalk,crossclassified,2,0,2
6479,dog,hotdog,synonymy,2,0,2
4999,boat,structure,crossclassified,2,2,0
11647,frisbee,surfer,crossclassified,2,0,2
10814,house,ship,crossclassified,2,2,0
920,food,mushroom,hypernymy.1,2,2,0
2297,croissant,roll,hypernymy.2,2,2,0
10812,mat,wheel,crossclassified,2,0,2
10811,ring,wheel,crossclassified,2,0,2
6507,bull,man,hypernymy.2,2,2,0
2710,boat,cargo,crossclassified,2,2,0
4994,cab,train,crossclassified,2,0,2
13948,curtain,shampoo,crossclassified,2,2,0
11651,cabinet,metacenter,crossclassified,2,2,0
2712,wooden,zebra,crossclassified,2,0,2
6504,chair,women,crossclassified,2,2,0
14573,cat,foot,crossclassified,2,2,0
6113,man,sweet,crossclassified,2,2,0
6111,bun,grill,crossclassified,2,0,2
6680,bed,cabinet,crossclassified,2,1,1
11436,painting,train,crossclassified,2,0,2
5438,display,vase,crossclassified,2,0,2
1112,pizza,tomatoes,crossclassified,2,2,0
5436,basketball,dugout,crossclassified,2,0,2
11396,pole,window,crossclassified,2,0,2
2478,dress,handbag,crossclassified,2,2,0
14278,boardwalk,sidewalk,co-hyponymy,2,0,2
5725,farmer,woman,crossclassified,2,0,2
15351,car,motor,crossclassified,2,2,0
5728,robe,ship,crossclassified,2,0,2
11402,carpet,self,crossclassified,2,2,0
5736,competitors,man,crossclassified,2,0,2
14274,smog,train,crossclassified,2,0,2
11230,baggage,bench,crossclassified,2,0,2
5414,train,trainbearer,crossclassified,2,2,0
5742,passengers,train,crossclassified,2,0,2
11227,skier,skis,crossclassified,2,2,0
15350,girl,tress,crossclassified,2,2,0
11394,door,vehicle,crossclassified,2,2,0
5715,plate,surfer,crossclassified,2,0,2
11245,baby,brush,crossclassified,2,2,0
14292,mo,motorcycle,crossclassified,2,0,2
11265,crumbs,knife,crossclassified,2,0,2
11380,chair,head,crossclassified,2,2,0
11381,bowl,foods,crossclassified,2,2,0
11382,foods,girl,crossclassified,2,0,2
5690,bridge,trailer,crossclassified,2,2,0
5691,bridge,signpost,crossclassified,2,2,0
5692,bridge,trafficked,crossclassified,2,2,0
11258,horse,stump,crossclassified,2,2,0
11246,baby,children,synonymy,2,2,0
5700,bed,controller,crossclassified,2,2,0
11252,ottoman,rug,crossclassified,2,0,2
11249,baby,hair,crossclassified,2,2,0
5443,house,trees,crossclassified,2,2,0
15352,cards,table,crossclassified,2,0,2
5710,surfer,teenager,crossclassified,2,2,0
11392,curtain,glasses,crossclassified,2,2,0
11225,flowers,house,crossclassified,2,1,1
15349,board,girl,crossclassified,2,0,2
2486,brush,table,crossclassified,2,0,2
14253,bear,picture,crossclassified,2,0,2
11202,chair,door,crossclassified,2,2,0
5791,fence,tent,crossclassified,2,0,2
11198,pant,van,crossclassified,2,0,2
5377,carpet,people,crossclassified,2,2,0
11195,bench,feeder,crossclassified,2,2,0
14254,doll,picture,crossclassified,2,0,2
11430,boat,mast,crossclassified,2,2,0
14423,boy,tourist,crossclassified,2,2,0
5784,man,wooden,crossclassified,2,2,0
5810,structure,tent,hypernymy.1,2,0,2
14427,rice,vegetables,crossclassified,2,2,0
14248,sail,windsurfing,crossclassified,2,2,0
11186,bowl,cabinet,crossclassified,2,0,2
1276,bin,bowl,co-hyponymy,2,0,2
5358,chair,wire,crossclassified,2,2,0
11434,belt,train,crossclassified,2,0,2
1265,cabinet,hubbard,crossclassified,2,2,0
5783,player,skier,crossclassified,2,0,2
14268,class,curtain,crossclassified,2,0,2
14412,person,snow,crossclassified,2,2,0
5757,scissors,table,crossclassified,2,0,2
5758,batter,stick,crossclassified,2,2,0
11414,jacket,skating,crossclassified,2,2,0
15647,knife,snack,crossclassified,2,2,0
11215,dresser,plate,crossclassified,2,2,0
5764,bicycle,train,crossclassified,2,0,2
5767,car,tailgate,crossclassified,2,2,0
11417,girl,shirts,crossclassified,2,2,0
11424,table,watch,crossclassified,2,2,0
2492,bird,sculpture,crossclassified,2,2,0
14413,person,skating,crossclassified,2,2,0
11418,girl,top,crossclassified,2,2,0
5774,doll,rice,crossclassified,2,0,2
14415,bowl,brutes,crossclassified,2,2,0
2493,bird,figurine,crossclassified,2,2,0
5385,person,photographer,hypernymy.1,2,2,0
14384,girl,mouse,crossclassified,2,2,0
11267,chair,umbrella,crossclassified,2,2,0
11268,blender,label,crossclassified,2,2,0
5511,shirt,utensil,crossclassified,2,2,0
14338,counter,hotdog,crossclassified,2,2,0
15367,bench,short,crossclassified,2,2,0
5588,curtain,plant,crossclassified,2,2,0
14357,baby,doll,co-hyponymy,2,2,0
11315,counter,newspaper,crossclassified,2,2,0
11314,counter,phone,crossclassified,2,2,0
5592,grill,sweet,crossclassified,2,2,0
5509,apple,wasp,crossclassified,2,2,0
11320,train,watercraft,crossclassified,2,2,0
11312,cat,sheep,crossclassified,2,0,2
5597,donut,grill,crossclassified,2,0,2
14333,board,child,crossclassified,2,0,2
5508,belting,building,crossclassified,2,0,2
11311,man,wood,crossclassified,2,2,0
14360,buffet,plate,crossclassified,2,2,0
14361,buffet,class,crossclassified,2,2,0
5522,cow,tail,crossclassified,2,2,0
1195,basket,fruit,crossclassified,2,0,2
15370,bears,bench,crossclassified,2,0,2
5559,catcher,dugout,crossclassified,2,0,2
5549,bagel,snack,crossclassified,2,2,0
5550,bagel,sweet,crossclassified,2,2,0
15658,painting,vase,crossclassified,2,0,2
1174,bridge,plane,crossclassified,2,2,0
11342,hummer,truck,crossclassified,2,0,2
5556,pastry,pie,hypernymy.1,2,0,2
11330,electronics,girl,crossclassified,2,0,2
5560,furniture,jacket,crossclassified,2,0,2
1158,bed,cabana,crossclassified,2,2,0
5538,man,sheep,crossclassified,2,2,0
5563,house,light,crossclassified,2,2,0
5536,van,vehicles,hypernymy.2,2,2,0
14345,battle,jar,crossclassified,2,0,2
2438,bed,steel,crossclassified,2,2,0
5533,bench,step,crossclassified,2,2,0
11324,bet,dugout,crossclassified,2,0,2
1149,desk,glasses,crossclassified,2,2,0
2447,couple,dress,crossclassified,2,2,0
14382,bricks,cat,crossclassified,2,2,0
1126,giraffe,gironde,crossclassified,2,2,0
11288,curtain,smoker,crossclassified,2,2,0
15359,aquarium,water,crossclassified,2,2,0
5472,keyboard,tray,crossclassified,2,2,0
1221,head,helmet,crossclassified,2,0,2
14310,cup,toaster,crossclassified,2,0,2
1222,face,helmet,crossclassified,2,0,2
5658,door,giraffe,crossclassified,2,0,2
5465,desk,scissor,crossclassified,2,2,0
14315,kettle,toaster,crossclassified,2,0,2
5464,desk,succors,crossclassified,2,2,0
5666,airplane,blackbird,crossclassified,2,2,0
2423,art,pottery,crossclassified,2,0,2
5669,bowl,paper,crossclassified,2,2,0
14301,bookshelf,girl,crossclassified,2,2,0
5459,food,marinara,hypernymy.1,2,2,0
1121,boat,boaters,crossclassified,2,2,0
14314,teapot,toaster,crossclassified,2,0,2
1208,cupcake,muffin,crossclassified,2,2,0
5610,blender,boll,crossclassified,2,2,0
14323,gown,phone,crossclassified,2,2,0
11358,bat,couch,crossclassified,2,0,2
2450,backdrop,fence,crossclassified,2,0,2
11301,carpet,charger,crossclassified,2,2,0
5616,bola,train,crossclassified,2,0,2
14325,gown,graduate,crossclassified,2,2,0
11300,carpet,wire,crossclassified,2,2,0
14324,gown,mobile,crossclassified,2,2,0
11362,mask,watch,crossclassified,2,2,0
5638,belt,umpire,crossclassified,2,0,2
14321,man,masque,crossclassified,2,2,0
11363,mask,toy,crossclassified,2,2,0
11293,house,pipe,crossclassified,2,2,0
11292,man,top,crossclassified,2,2,0
5496,platform,tracks,crossclassified,2,1,1
5631,scarf,skier,crossclassified,2,0,2
1139,machine,tractor,crossclassified,2,0,2
5825,cake,carpet,crossclassified,2,0,2
11176,model,table,crossclassified,2,0,2
11526,pole,van,crossclassified,2,0,2
5346,bowtie,man,crossclassified,2,0,2
5264,competitor,woman,crossclassified,2,0,2
14171,bowl,girl,crossclassified,2,0,2
14466,clock,steeple,crossclassified,2,2,0
15329,board,pool,crossclassified,2,0,2
5257,basket,rug,crossclassified,2,0,2
6004,bridge,pathway,crossclassified,2,2,0
5256,rug,tray,crossclassified,2,2,0
2559,hat,sunglasses,crossclassified,2,2,0
5254,bucket,pail,synonymy,2,2,0
6010,board,pizza,crossclassified,2,0,2
2560,glass,hat,crossclassified,2,0,2
2563,banner,building,crossclassified,2,0,2
6017,scooter,vehicles,hypernymy.2,2,2,0
14468,boy,cooker,crossclassified,2,2,0
6019,people,skateboarder,crossclassified,2,0,2
11486,laptop,shelf,crossclassified,2,0,2
6022,pretzel,sandwich,crossclassified,2,2,0
1312,girl,snakes,crossclassified,2,2,0
2554,snowboard,tent,crossclassified,2,0,2
11092,bug,grasshopper,crossclassified,2,2,0
1304,cupcake,hat,crossclassified,2,0,2
2541,table,tissue,crossclassified,2,2,0
1020,chair,outfit,crossclassified,2,2,0
5967,covering,tent,crossclassified,2,0,2
2373,onlooker,woman,crossclassified,2,0,2
5970,child,men,co-hyponymy,2,2,0
5971,child,snow,crossclassified,2,2,0
5972,man,trousers,crossclassified,2,2,0
2550,booth,coffee,crossclassified,2,2,0
5989,person,track,crossclassified,2,2,0
14174,dog,monkey,crossclassified,2,2,0
5982,donut,doughnut,synonymy,2,2,0
5984,man,padre,crossclassified,2,2,0
14460,apparel,shirt,crossclassified,2,0,2
5274,person,server,hypernymy.1,2,2,0
5987,outfit,person,crossclassified,2,0,2
5988,clothes,person,crossclassified,2,0,2
6024,ampullae,tent,crossclassified,2,0,2
15820,hitter,pants,crossclassified,2,0,2
14157,jacket,sidewalk,crossclassified,2,2,0
6087,counter,shorts,crossclassified,2,2,0
5231,bagel,cookie,crossclassified,2,2,0
5229,baseball,catcher,crossclassified,2,0,2
6067,owner,woman,crossclassified,2,0,2
14137,owl,picture,crossclassified,2,2,0
5223,coat,toy,crossclassified,2,2,0
6085,fork,sandwich,crossclassified,2,2,0
6086,apples,counter,crossclassified,2,0,2
6097,shirt,waist,crossclassified,2,2,0
2570,carpet,pole,crossclassified,2,2,0
14125,couch,purse,crossclassified,2,2,0
2584,child,skating,crossclassified,2,2,0
1316,cookie,table,crossclassified,2,0,2
5214,counter,girls,crossclassified,2,2,0
2588,hotdog,knife,crossclassified,2,2,0
15323,backpack,couch,crossclassified,2,0,2
6109,griddle,grill,crossclassified,2,0,2
6061,dwelling,house,hypernymy.1,2,0,2
11057,jeans,keyboard,crossclassified,2,0,2
1000,mug,pitcher,co-hyponymy,2,2,0
15689,bird,watch,crossclassified,2,2,0
11074,screen,tent,crossclassified,2,0,2
11489,table,toast,crossclassified,2,2,0
11490,bus,trolley,crossclassified,2,0,2
6032,poultry,turkey,hypernymy.1,2,0,2
6033,duck,turkey,co-hyponymy,2,0,2
14155,cat,fur,crossclassified,2,2,0
6035,helicopter,jet,crossclassified,2,1,1
2565,food,meatloaf,hypernymy.1,2,2,0
11502,display,paper,crossclassified,2,2,0
11494,tram,trolley,synonymy,2,0,2
11495,trolley,vehicle,hypernymy.2,2,2,0
6049,horse,sculpture,crossclassified,2,2,0
6050,ball,catcher,crossclassified,2,0,2
11499,desk,note,crossclassified,2,2,0
14476,lamp,woman,crossclassified,2,0,2
991,bottle,food,crossclassified,2,2,0
11476,shark,shoe,crossclassified,2,2,0
11106,antique,car,crossclassified,2,0,2
5961,cake,graph,crossclassified,2,2,0
14225,candle,dog,crossclassified,2,0,2
15676,car,tent,crossclassified,2,0,2
5333,counter,things,crossclassified,2,2,0
5863,automobile,scooter,crossclassified,2,0,2
11446,person,teenager,hypernymy.1,2,2,0
14226,dog,food,hypernymy.2,2,2,0
15677,people,tent,crossclassified,2,0,2
5870,cap,suit,crossclassified,2,0,2
5326,couch,lap,crossclassified,2,2,0
15644,bookshelf,nooks,crossclassified,2,2,0
5876,bathrooms,carpet,crossclassified,2,0,2
11154,building,flag,crossclassified,2,2,0
5878,carpet,handle,crossclassified,2,2,0
11450,bench,statue,crossclassified,2,2,0
5883,batter,playing,crossclassified,2,2,0
5884,jacket,seat,crossclassified,2,2,0
5323,chair,sitting,crossclassified,2,2,0
5858,cow,lamb,crossclassified,2,2,0
11444,cycle,girl,crossclassified,2,0,2
1046,merchandise,table,crossclassified,2,0,2
5842,dresser,television,crossclassified,2,1,1
5832,care,horse,crossclassified,2,0,2
2393,dryer,toilet,crossclassified,2,0,2
5344,chairs,rug,crossclassified,2,0,2
5837,hutch,television,crossclassified,2,0,2
5838,shelf,television,crossclassified,2,1,1
11170,plain,plane,crossclassified,2,0,2
14237,backpack,jacket,crossclassified,2,0,2
11169,moped,person,crossclassified,2,0,2
14231,bench,dewy,crossclassified,2,2,0
11168,person,rider,hypernymy.1,2,2,0
14234,child,toys,crossclassified,2,2,0
2392,toilet,toilette,synonymy,2,2,0
5342,boat,tube,crossclassified,2,2,0
2518,shoe,vase,crossclassified,2,0,2
11440,base,rug,crossclassified,2,0,2
5852,carpet,shelf,crossclassified,2,2,0
1047,platform,table,crossclassified,2,0,2
1044,horse,reigns,crossclassified,2,2,0
5959,flower,petals,crossclassified,2,2,0
5295,bowl,sweet,crossclassified,2,2,0
5932,bench,skater,crossclassified,2,2,0
5934,bathtub,tools,crossclassified,2,2,0
11119,kite,rub,crossclassified,2,2,0
5301,saxophone,shirt,crossclassified,2,0,2
1027,bowl,cheerios,crossclassified,2,2,0
5297,jacket,strap,crossclassified,2,2,0
5296,bowl,lunch,crossclassified,2,2,0
11112,flamingo,nook,crossclassified,2,2,0
5930,bench,road,crossclassified,2,2,0
2376,boat,cruise,crossclassified,2,2,0
11109,knob,table,crossclassified,2,0,2
5954,cathedral,tower,crossclassified,2,0,2
5285,doily,table,crossclassified,2,0,2
14185,bird,book,crossclassified,2,2,0
5957,castle,tower,crossclassified,2,1,1
11475,dress,shark,crossclassified,2,0,2
2383,man,rollerblade,crossclassified,2,2,0
11122,float,kite,crossclassified,2,0,2
11147,bowl,fork,crossclassified,2,1,1
1041,stand,vase,crossclassified,2,0,2
14213,plane,toy,crossclassified,2,2,0
5897,dresser,mantle,crossclassified,2,0,2
11455,boat,paws,crossclassified,2,2,0
11141,closet,doorway,crossclassified,2,0,2
14208,came,woman,crossclassified,2,0,2
2389,bags,woman,crossclassified,2,0,2
11137,doorway,shed,crossclassified,2,2,0
11130,house,scaffolding,crossclassified,2,2,0
11123,doll,kite,co-hyponymy,2,0,2
5308,bedframe,carpet,crossclassified,2,0,2
5307,bed,footboard,crossclassified,2,2,0
11129,cricket,man,crossclassified,2,0,2
5920,carriage,stagecoach,hypernymy.1,2,2,0
11126,dog,see,crossclassified,2,2,0
5926,broccoli,soup,crossclassified,2,0,2
5927,house,men,crossclassified,2,2,0
2762,bag,coat,crossclassified,2,0,2
14550,arugula,pizza,crossclassified,2,0,2
15083,cabinet,head,crossclassified,2,2,0
7058,grill,truck,crossclassified,2,0,2
2824,luggage,woman,crossclassified,2,0,2
10491,building,landmark,crossclassified,2,2,0
6819,house,railing,crossclassified,2,2,0
10624,pant,snow,crossclassified,2,0,2
11835,ambulance,van,crossclassified,2,1,1
1460,hat,pitcher,crossclassified,2,0,2
14689,shirt,statue,crossclassified,2,2,0
2175,platter,tray,crossclassified,2,0,2
10626,shoe,snow,crossclassified,2,0,2
1461,ball,pitcher,crossclassified,2,0,2
4811,booth,chair,crossclassified,2,1,1
2822,bird,brides,crossclassified,2,2,0
6813,chair,children,crossclassified,2,2,0
7067,desk,radio,crossclassified,2,2,0
11837,bed,vanity,crossclassified,2,2,0
11752,jacket,van,crossclassified,2,0,2
10486,die,tie,crossclassified,2,0,2
14692,tern,train,crossclassified,2,0,2
10631,jacket,remote,crossclassified,2,1,1
6807,plate,sweater,crossclassified,2,0,2
10484,skateboarder,sweatshirt,crossclassified,2,2,0
13797,bookshelf,counter,crossclassified,2,2,0
6804,girl,smile,crossclassified,2,2,0
4682,land,runway,crossclassified,2,0,2
2225,crane,swan,crossclassified,2,0,2
4844,car,runway,crossclassified,2,0,2
13789,cheese,mayonnaise,crossclassified,2,2,0
11761,mattress,rug,crossclassified,2,0,2
13774,cow,utters,crossclassified,2,2,0
6846,counter,workstation,crossclassified,2,2,0
10499,building,lights,crossclassified,2,2,0
2181,shirt,tennis,crossclassified,2,2,0
4805,noodle,soup,crossclassified,2,0,2
13680,bad,curtain,crossclassified,2,0,2
6841,pole,rug,crossclassified,2,0,2
2830,bag,plane,crossclassified,2,0,2
13778,mask,shirt,crossclassified,2,0,2
868,cabinet,tv,crossclassified,2,2,0
13779,pavilion,shelter,hypernymy.2,2,0,2
13676,bridge,short,crossclassified,2,2,0
4806,dumplings,soup,crossclassified,2,0,2
6834,food,truck,crossclassified,2,0,2
13675,bridge,trouser,crossclassified,2,2,0
7052,broccoli,pot,crossclassified,2,2,0
13785,bowl,butterfly,crossclassified,2,2,0
4808,dinner,soup,crossclassified,2,0,2
4683,airfield,runway,crossclassified,2,0,2
15725,boat,hap,crossclassified,2,2,0
7057,house,road,crossclassified,2,2,0
10619,skateboarder,top,crossclassified,2,2,0
10481,cake,flowers,crossclassified,2,2,0
1433,taxi,taxicab,synonymy,2,2,0
11839,baby,bathtub,crossclassified,2,0,2
13666,meat,sauce,crossclassified,2,2,0
13656,bear,floor,crossclassified,2,0,2
10468,blanket,pants,crossclassified,2,2,0
7096,cycle,wheelchair,crossclassified,2,0,2
4836,bow,shirt,crossclassified,2,0,2
10662,cappuccino,cup,crossclassified,2,0,2
6764,chili,sauce,crossclassified,2,1,1
13654,pole,tracks,crossclassified,2,0,2
10665,bathtub,washermen,crossclassified,2,2,0
6759,burger,mustard,crossclassified,2,0,2
4839,asphalt,runway,crossclassified,2,0,2
13653,sidewalk,tracks,crossclassified,2,0,2
13652,carpet,woman,crossclassified,2,2,0
13651,pot,potatoes,crossclassified,2,2,0
2916,man,reporter,crossclassified,2,2,0
13649,pot,vegetable,crossclassified,2,2,0
7104,pole,shirt,crossclassified,2,0,2
4841,lot,runway,crossclassified,2,0,2
6750,cereal,donut,crossclassified,2,0,2
10465,blanket,saddle,crossclassified,2,2,0
13831,bowl,plat,crossclassified,2,2,0
1485,squirrel,tree,crossclassified,2,2,0
10464,blanket,knee,crossclassified,2,2,0
13833,kite,sail,crossclassified,2,1,1
13817,hippo,toy,crossclassified,2,0,2
13657,floor,glass,crossclassified,2,2,0
7092,building,resort,hypernymy.1,2,2,0
11743,board,restaurant,crossclassified,2,0,2
6801,pants,train,crossclassified,2,0,2
10634,remote,sofa,crossclassified,2,2,0
10478,body,chair,crossclassified,2,0,2
10636,cabinets,steel,crossclassified,2,2,0
10637,cabinets,stove,crossclassified,2,2,0
6789,seat,sidecar,crossclassified,2,0,2
6788,cart,sidecar,crossclassified,2,0,2
10647,shelf,wood,crossclassified,2,2,0
11844,bench,hampton,crossclassified,2,2,0
10648,door,shelf,crossclassified,2,1,1
7086,bed,children,crossclassified,2,2,0
10657,legs,rug,crossclassified,2,0,2
874,dessert,plate,crossclassified,2,0,2
14633,coral,creature,hypernymy.2,2,2,0
10472,bird,waterfowl,hypernymy.1,2,2,0
10470,horse,stick,crossclassified,2,2,0
11742,pole,restaurant,crossclassified,2,0,2
11741,glass,restaurant,crossclassified,2,0,2
15267,fence,ramp,crossclassified,2,2,0
6776,t-shirt,vest,crossclassified,2,0,2
15806,filet,fish,crossclassified,2,0,2
10656,bed,bottle,crossclassified,2,2,0
11762,sign,table,crossclassified,2,0,2
6850,spoon,vest,crossclassified,2,0,2
14688,coke,sandwich,crossclassified,2,0,2
6900,glove,strap,crossclassified,2,2,0
2869,bed,ottoman,crossclassified,2,1,1
2871,furniture,ottoman,hypernymy.1,2,0,2
10543,pig,pinata,crossclassified,2,2,0
6966,apron,clothing,hypernymy.2,2,2,0
6967,apron,clothes,crossclassified,2,2,0
139,robe,washroom,crossclassified,2,2,0
2875,clothing,person,crossclassified,2,0,2
4731,butterfly,insect,hypernymy.2,2,2,0
11800,dresser,knob,crossclassified,2,2,0
6973,chicken,pizza,crossclassified,2,0,2
11801,cycle,tent,crossclassified,2,0,2
11802,camping,tent,crossclassified,2,0,2
10567,buffet,woman,crossclassified,2,0,2
10568,boy,show,crossclassified,2,2,0
11804,tent,vehicle,crossclassified,2,2,0
10570,melon,vegetable,crossclassified,2,2,0
4726,street,walkway,crossclassified,2,2,0
14664,banana,meat,crossclassified,2,2,0
11783,patio,vase,crossclassified,2,2,0
13744,child,hood,crossclassified,2,0,2
2849,motorcycle,sidewalk,crossclassified,2,2,0
14659,banana,pickle,crossclassified,2,2,0
6901,glove,louse,crossclassified,2,2,0
4739,kicker,woman,crossclassified,2,0,2
10563,cooker,counter,crossclassified,2,0,2
10561,basket,bread,crossclassified,2,0,2
6947,motorcycle,street,crossclassified,2,1,1
11792,carpet,computer,crossclassified,2,2,0
11791,carpet,flowerpot,crossclassified,2,2,0
10554,glass,tent,crossclassified,2,0,2
6941,man,white,hypernymy.1,2,2,0
13724,box,jacket,crossclassified,2,0,2
4751,desserts,tray,crossclassified,2,0,2
6944,fence,street,crossclassified,2,0,2
11789,bounding,building,crossclassified,2,0,2
6945,street,truck,crossclassified,2,2,0
6946,building,street,crossclassified,2,1,1
6948,street,vehicle,crossclassified,2,2,0
2208,boy,toys,crossclassified,2,2,0
14665,bad,bed,crossclassified,2,0,2
6931,blender,fruit,crossclassified,2,2,0
10550,ski,snowboarder,crossclassified,2,0,2
2868,ottoman,stool,hypernymy.2,2,2,0
6954,bathtub,top,crossclassified,2,2,0
6956,bridge,person,crossclassified,2,2,0
4756,ledge,shelf,synonymy,2,0,2
13728,mask,t-shirt,crossclassified,2,2,0
4758,pot,shelf,crossclassified,2,0,2
4742,burro,horse,crossclassified,2,0,2
4725,pavement,street,crossclassified,2,0,2
6897,fingers,glove,crossclassified,2,0,2
4691,burger,pancake,crossclassified,2,0,2
10579,man,motile,crossclassified,2,2,0
4796,bridge,trolley,crossclassified,2,2,0
4709,bet,couch,crossclassified,2,0,2
15247,cover,man,crossclassified,2,0,2
7012,nerd,person,hypernymy.2,2,0,2
13692,desk,hands,crossclassified,2,2,0
11769,shed,shirt,crossclassified,2,2,0
13691,arm,desk,crossclassified,2,0,2
6868,food,tart,hypernymy.1,2,2,0
13761,frog,toilet,crossclassified,2,0,2
4700,fine,spatula,crossclassified,2,0,2
7022,truck,wagon,hypernymy.1,2,2,0
6862,glider,sky,crossclassified,2,2,0
6861,glider,vehicle,hypernymy.2,2,2,0
14685,sand,woman,crossclassified,2,0,2
14647,family,house,synonymy,2,0,2
2901,vegetable,woman,crossclassified,2,0,2
2839,jacket,male,crossclassified,2,2,0
859,bench,sitting,crossclassified,2,2,0
10601,appliance,kettle,crossclassified,2,0,2
7031,machine,oven,crossclassified,2,0,2
2903,ball,rug,crossclassified,2,0,2
7033,jacket,skate,crossclassified,2,2,0
11765,cape,chair,crossclassified,2,0,2
6877,bun,sauce,crossclassified,2,0,2
2845,headlamp,motorcycle,crossclassified,2,0,2
10588,collar,t-shirt,crossclassified,2,2,0
10583,show,skier,crossclassified,2,0,2
10528,kitten,puppy,crossclassified,2,2,0
4721,car,taxicab,hypernymy.1,2,2,0
4720,bed,loge,crossclassified,2,2,0
6988,light,vase,crossclassified,2,0,2
10526,stone,tracks,crossclassified,2,0,2
6991,marcel,sauce,crossclassified,2,0,2
13701,counter,watch,crossclassified,2,2,0
6994,burger,sauce,crossclassified,2,0,2
6995,cream,sauce,crossclassified,2,0,2
4775,cruise,ship,crossclassified,2,0,2
11812,bowl,strawberry,crossclassified,2,2,0
11772,man,shed,crossclassified,2,0,2
1448,leaf,vase,crossclassified,2,0,2
6889,radish,table,crossclassified,2,0,2
14655,lettuce,table,crossclassified,2,0,2
2434,dog,hood,crossclassified,2,0,2
7004,monocycle,motorcycle,crossclassified,2,0,2
7005,ducat,motorcycle,crossclassified,2,0,2
846,bench,pigeon,crossclassified,2,2,0
4711,bun,sauerkraut,crossclassified,2,2,0
10518,statue,toll,crossclassified,2,2,0
2892,face,giraffe,crossclassified,2,0,2
4842,racetrack,runway,crossclassified,2,0,2
6940,boarder,woman,crossclassified,2,0,2
6708,drinks,floor,crossclassified,2,0,2
4639,girl,teeth,crossclassified,2,2,0
6696,mantle,vent,crossclassified,2,0,2
13857,beard,neck,crossclassified,2,2,0
11863,helicopter,vehicle,hypernymy.2,2,2,0
11864,bike,helicopter,crossclassified,2,0,2
14623,body,cow,crossclassified,2,0,2
2785,desserts,table,crossclassified,2,0,2
14706,bathtub,cup,crossclassified,2,2,0
6720,casserole,food,hypernymy.2,2,0,2
14616,car,frisbee,crossclassified,2,2,0
14625,cow,torso,crossclassified,2,2,0
2763,coat,pant,crossclassified,2,2,0
4865,sweater,table,crossclassified,2,0,2
7113,bread,dress,crossclassified,2,1,1
4638,pizza,tortilla,crossclassified,2,2,0
6738,scoreboard,wristband,crossclassified,2,2,0
7114,dress,hotdog,crossclassified,2,2,0
13633,football,man,crossclassified,2,0,2
6739,scoreboard,signboard,hypernymy.2,2,2,0
11866,desk,leg,crossclassified,2,2,0
4635,bridge,vest,crossclassified,2,2,0
4634,bridge,ground,crossclassified,2,2,0
15715,girl,rope,crossclassified,2,2,0
13837,clock,sofa,crossclassified,2,2,0
13858,beard,hood,crossclassified,2,2,0
1491,jam,pizza,crossclassified,2,0,2
7145,giraffe,riffraff,crossclassified,2,2,0
2260,box,chair,co-hyponymy,2,0,2
15273,church,tree,crossclassified,2,2,0
7120,overskirt,shirt,crossclassified,2,0,2
10698,shirty,surfer,crossclassified,2,0,2
11853,boat,station,crossclassified,2,2,0
10683,airplane,dog,crossclassified,2,0,2
6726,hotdogs,sandwich,hypernymy.2,2,1,1
2261,chair,coach,crossclassified,2,2,0
15239,man,motorbike,crossclassified,2,2,0
10696,cabinet,steel,crossclassified,2,2,0
6703,chimney,vent,crossclassified,2,0,2
11724,gift,table,crossclassified,2,0,2
4856,food,jar,crossclassified,2,0,2
884,streetlight,window,crossclassified,2,2,0
13845,cookie,cupcakes,co-hyponymy,2,0,2
2786,sweets,table,crossclassified,2,0,2
4854,cereal,jar,crossclassified,2,0,2
2922,statue,stone,crossclassified,2,2,0
13632,witch,woman,hypernymy.2,2,0,2
11860,car,shirts,crossclassified,2,2,0
166,sweet,woman,crossclassified,2,0,2
4625,stick,woman,crossclassified,2,0,2
6704,vent,wall,crossclassified,2,2,0
6697,cabinet,vent,crossclassified,2,0,2
2771,boat,box,crossclassified,2,2,0
2259,dog,snout,crossclassified,2,2,0
2927,animal,statue,crossclassified,2,0,2
7164,child,pole,crossclassified,2,2,0
7140,headgear,woman,crossclassified,2,0,2
7139,sari,woman,crossclassified,2,0,2
7135,pickle,plate,crossclassified,2,2,0
4648,chair,mike,crossclassified,2,2,0
7141,motherliness,woman,crossclassified,2,0,2
11847,grill,laptop,crossclassified,2,2,0
6713,car,surfboards,crossclassified,2,2,0
6684,cake,rug,crossclassified,2,0,2
4620,man,pullover,crossclassified,2,2,0
13860,desk,suitcase,crossclassified,2,2,0
2925,leaf,statue,crossclassified,2,0,2
6685,boy,sock,crossclassified,2,2,0
10446,beat,rug,crossclassified,2,0,2
11857,bench,bike,crossclassified,2,2,0
7136,food,pickle,hypernymy.1,2,0,2
2917,man,newscaster,crossclassified,2,2,0
10429,sandwich,vegetable,crossclassified,2,2,0
11716,box,truck,crossclassified,2,0,2
13859,bag,desk,crossclassified,2,0,2
6714,carpet,paws,crossclassified,2,2,0
12382,chair,tuxedo,crossclassified,1,1,0
11449,bowl,shop,crossclassified,1,1,0
15444,bench,shari,crossclassified,1,1,0
11938,palladian,vase,crossclassified,1,0,1
11814,cabinet,vessels,crossclassified,1,1,0
12402,van,water,crossclassified,1,1,0
11946,rug,shake,crossclassified,1,1,0
11876,pot,utensil,hypernymy.2,1,1,0
11467,base,dirt,crossclassified,1,0,1
11878,empennage,plane,crossclassified,1,0,1
11945,arm,rug,crossclassified,1,0,1
11940,drapes,woman,crossclassified,1,0,1
11465,batter,dirt,crossclassified,1,0,1
15248,shirt,skating,crossclassified,1,1,0
15335,pool,rink,crossclassified,1,1,0
11944,handshake,rug,crossclassified,1,0,1
11821,bench,monochrome,crossclassified,1,1,0
11822,fork,vegetates,crossclassified,1,1,0
11352,bench,reading,crossclassified,1,1,0
12399,firefighter,van,crossclassified,1,0,1
15249,bed,bodice,crossclassified,1,1,0
11947,rug,sleeve,crossclassified,1,1,0
15250,bridge,cargo,crossclassified,1,1,0
11471,dirt,man,crossclassified,1,1,0
15821,beach,dog,crossclassified,1,0,1
15822,ford,truck,crossclassified,1,0,1
15121,blanket,gown,crossclassified,1,1,0
11950,carpet,sandal,crossclassified,1,1,0
15116,business,jacket,crossclassified,1,0,1
12510,bench,duo,crossclassified,1,1,0
11470,clay,dirt,hypernymy.2,1,0,1
12376,chair,suspender,crossclassified,1,1,0
11469,dirt,ground,hypernymy.2,1,1,0
12378,thunderstruck,truck,crossclassified,1,0,1
15365,dog,legs,co-hyponymy,1,1,0
15386,candy,seat,crossclassified,1,0,1
12519,bed,people,crossclassified,1,1,0
11881,desk,moldboard,crossclassified,1,1,0
15433,person,toilet,crossclassified,1,1,0
11948,rug,suit,crossclassified,1,1,0
12379,antenna,car,crossclassified,1,0,1
11941,hand,rug,crossclassified,1,0,1
11468,dirt,home,crossclassified,1,1,0
11824,chair,legs,crossclassified,1,1,0
11448,airplane,mattress,crossclassified,1,1,0
15118,blanket,tapestry,crossclassified,1,1,0
12511,bench,violin,crossclassified,1,1,0
12384,futon,shirt,crossclassified,1,1,0
12517,butt,couch,crossclassified,1,0,1
12520,bed,trash,crossclassified,1,1,0
12391,couch,divan,hypernymy.1,1,1,0
15245,bewared,motorcycle,crossclassified,1,0,1
12392,pumpkin,truck,crossclassified,1,0,1
12393,bench,pyjamas,crossclassified,1,1,0
12394,airplane,reporter,crossclassified,1,1,0
11457,carpet,home,crossclassified,1,1,0
11456,couch,quilt,crossclassified,1,1,0
15808,boy,specs,crossclassified,1,1,0
15246,motorcycle,sky,crossclassified,1,1,0
15225,building,villa,hypernymy.1,1,1,0
15486,curtain,tubs,crossclassified,1,1,0
12396,boy,desk,crossclassified,1,0,1
15338,graffiti,pool,crossclassified,1,0,1
12513,chair,golfer,crossclassified,1,1,0
11454,bench,crow,crossclassified,1,1,0
11858,mate,table,crossclassified,1,0,1
11452,bench,photo,crossclassified,1,1,0
12397,car,red,crossclassified,1,1,0
12398,planks,table,crossclassified,1,0,1
11818,curtain,maker,crossclassified,1,1,0
12400,pump,van,crossclassified,1,0,1
11880,desk,knob,crossclassified,1,1,0
12514,car,nose,crossclassified,1,1,0
15487,shier,van,crossclassified,1,0,1
15366,dog,mud,crossclassified,1,1,0
12388,car,classic,crossclassified,1,1,0
15086,gloss,glove,crossclassified,1,0,1
11879,cup,paper,crossclassified,1,1,0
15795,leek,produce,hypernymy.2,1,1,0
15381,chair,peacock,crossclassified,1,0,1
15117,bench,papers,crossclassified,1,1,0
11453,bench,peak,crossclassified,1,1,0
11451,bench,sculpture,crossclassified,1,1,0
12516,belt,scooter,crossclassified,1,0,1
11464,dirt,plate,crossclassified,1,1,0
12387,cloth,futon,crossclassified,1,0,1
15336,bowl,pool,crossclassified,1,0,1
15382,bed,vehicle,crossclassified,1,1,0
15337,dip,pool,crossclassified,1,0,1
11461,man,oven,crossclassified,1,1,0
11460,dustbin,man,crossclassified,1,0,1
11943,coat,rug,crossclassified,1,0,1
11459,cupboard,man,crossclassified,1,0,1
12515,counter,marketable,crossclassified,1,1,0
15428,core,woman,crossclassified,1,0,1
11820,couch,recliner,crossclassified,1,1,0
11458,coke,man,crossclassified,1,0,1
15384,seat,snakes,crossclassified,1,1,0
11377,animal,bridge,crossclassified,1,0,1
15238,desk,poster,crossclassified,1,1,0
11472,table,towel,crossclassified,1,1,0
11484,airplane,field,crossclassified,1,1,0
15484,ass,horse,co-hyponymy,1,0,1
12357,rug,top,crossclassified,1,1,0
12358,railing,rug,crossclassified,1,0,1
12530,bench,monument,crossclassified,1,1,0
11488,shelf,understand,crossclassified,1,1,0
11873,okra,pot,crossclassified,1,0,1
11969,foods,knife,crossclassified,1,0,1
15129,bodice,sofa,crossclassified,1,0,1
11968,cabin,sink,crossclassified,1,0,1
11485,building,cow,crossclassified,1,1,0
12529,bookshelf,sing,crossclassified,1,1,0
11797,bench,rack,crossclassified,1,1,0
11967,house,shaded,crossclassified,1,1,0
11966,carpet,harpooner,crossclassified,1,1,0
15485,fork,paper,crossclassified,1,1,0
15241,building,place,crossclassified,1,1,0
15389,cushion,seat,crossclassified,1,0,1
11483,airplane,screen,crossclassified,1,1,0
12359,decoration,rug,crossclassified,1,0,1
12360,cloth,counter,crossclassified,1,0,1
12361,cosmetics,counter,crossclassified,1,0,1
12362,roses,table,crossclassified,1,0,1
12528,bookshelf,toilet,crossclassified,1,1,0
12363,biscuit,table,crossclassified,1,0,1
15369,coffee,man,crossclassified,1,0,1
15388,donut,seat,crossclassified,1,0,1
12527,bed,pouch,crossclassified,1,1,0
15128,jacket,tercentennial,crossclassified,1,1,0
15084,cabinet,person,crossclassified,1,1,0
11964,boat,schooner,crossclassified,1,1,0
11970,cone,motorcycle,crossclassified,1,0,1
11795,building,top,crossclassified,1,1,0
11794,building,shirts,crossclassified,1,1,0
11971,bridge,bun,crossclassified,1,1,0
15446,nickname,vase,crossclassified,1,0,1
11339,building,vase,crossclassified,1,1,0
11870,dresser,sink,crossclassified,1,0,1
12348,carpet,sneakers,crossclassified,1,1,0
11869,carpet,cover,co-hyponymy,1,1,0
15803,experiment,table,crossclassified,1,0,1
11498,table,tall,crossclassified,1,1,0
15483,horse,packhorse,hypernymy.1,1,1,0
15390,seat,wall,crossclassified,1,1,0
12533,chair,ring,crossclassified,1,1,0
11496,streetcar,trolley,synonymy,1,0,1
15254,man,patrolman,crossclassified,1,1,0
12532,bench,woolen,crossclassified,1,1,0
11493,animal,trolley,crossclassified,1,0,1
11340,hire,woman,crossclassified,1,0,1
15130,sofa,southpaw,crossclassified,1,1,0
12350,bench,board,crossclassified,1,1,0
11868,cap,counter,crossclassified,1,0,1
11492,trolley,window,crossclassified,1,1,0
12351,couch,sweatshirt,crossclassified,1,1,0
11491,pant,trolley,crossclassified,1,0,1
12352,couch,scarf,crossclassified,1,1,0
12353,carpet,countertop,crossclassified,1,1,0
15798,leek,table,crossclassified,1,1,0
12354,paint,truck,crossclassified,1,0,1
11341,desk,return,crossclassified,1,1,0
12355,ice,truck,crossclassified,1,0,1
11867,counter,outfit,crossclassified,1,1,0
12356,couch,waffle,crossclassified,1,1,0
11482,seedcase,woman,crossclassified,1,0,1
11963,blade,plate,co-hyponymy,1,0,1
15499,cartoon,woman,crossclassified,1,0,1
15332,pool,skate,crossclassified,1,1,0
12524,divider,wall,hypernymy.1,1,0,1
11805,bicycle,tent,crossclassified,1,0,1
12372,calculate,desk,crossclassified,1,0,1
11957,printer,rug,crossclassified,1,0,1
11346,kite,shirt,crossclassified,1,1,0
15251,ire,man,crossclassified,1,0,1
11347,kite,rod,crossclassified,1,1,0
12373,playmate,rug,crossclassified,1,0,1
11348,capote,desk,crossclassified,1,0,1
11806,couch,tab,crossclassified,1,1,0
15123,blanket,covering,hypernymy.2,1,1,0
11807,couch,magazine,crossclassified,1,1,0
15224,building,leander,crossclassified,1,1,0
11953,soil,vase,crossclassified,1,0,1
15387,seat,snack,crossclassified,1,1,0
15488,garden,van,crossclassified,1,0,1
11808,headlamp,truck,crossclassified,1,0,1
15240,breach,building,crossclassified,1,0,1
12522,tile,wall,crossclassified,1,0,1
12521,counter,meat,crossclassified,1,1,0
11951,bed,doubles,crossclassified,1,1,0
11809,cabinet,speaker,crossclassified,1,1,0
11349,shoes,truck,crossclassified,1,0,1
11474,pants,shark,crossclassified,1,0,1
11473,desk,spoon,crossclassified,1,1,0
15796,leek,plant,hypernymy.2,1,1,0
15122,blanket,garment,crossclassified,1,1,0
11810,cabinet,dishwasher,crossclassified,1,1,0
12374,bench,teddy,crossclassified,1,1,0
15124,gloves,house,crossclassified,1,0,1
11478,man,shark,crossclassified,1,0,1
11865,bedroom,desk,crossclassified,1,0,1
15498,girl,men,crossclassified,1,1,0
12364,scooter,statue,crossclassified,1,1,0
15427,loveseat,window,crossclassified,1,0,1
15445,gift,vase,crossclassified,1,0,1
15330,pool,skateboard,crossclassified,1,1,0
12365,train,unclear,crossclassified,1,1,0
15127,skier,spectacle,crossclassified,1,1,0
11862,couch,shirts,crossclassified,1,1,0
12366,runway,wings,crossclassified,1,1,0
11962,bed,leggings,crossclassified,1,1,0
12367,runway,sky,crossclassified,1,1,0
15126,house,refrigerator,crossclassified,1,1,0
12368,engine,runway,crossclassified,1,0,1
11961,desk,maker,crossclassified,1,1,0
11861,car,lady,crossclassified,1,1,0
11344,kite,screen,crossclassified,1,1,0
12369,headlamp,train,crossclassified,1,0,1
11803,hunt,tent,crossclassified,1,0,1
11481,tyke,woman,crossclassified,1,0,1
12526,partition,wall,hypernymy.1,1,0,1
12370,chair,eye,crossclassified,1,1,0
15823,girl,toilet,crossclassified,1,1,0
12525,blinds,wall,crossclassified,1,0,1
11480,male,woman,crossclassified,1,0,1
11345,flamingo,kite,crossclassified,1,0,1
11479,clothes,shark,crossclassified,1,0,1
15125,house,ire,crossclassified,1,1,0
15331,pool,shoe,crossclassified,1,1,0
15222,building,hum,crossclassified,1,1,0
11958,chair,chaises,hypernymy.1,1,1,0
12509,box,couch,co-hyponymy,1,0,1
12411,kite,parachute,crossclassified,1,0,1
11447,contestant,person,hypernymy.2,1,0,1
12462,rug,vanity,crossclassified,1,1,0
11403,cabinet,carpet,crossclassified,1,0,1
11404,carpet,florin,crossclassified,1,1,0
11907,clock,streetwalker,crossclassified,1,1,0
15440,amarillo,shirt,crossclassified,1,0,1
12463,rug,washroom,crossclassified,1,1,0
11908,clock,light,crossclassified,1,1,0
12461,arch,rug,crossclassified,1,0,1
15348,bridge,skateboarding,crossclassified,1,1,0
11890,canopy,storefront,crossclassified,1,0,1
12460,cockpit,train,crossclassified,1,0,1
12459,car,clock,crossclassified,1,1,0
12458,car,weightlifting,crossclassified,1,1,0
12493,carpet,pot,crossclassified,1,1,0
12457,car,watch,crossclassified,1,1,0
12464,controllership,table,crossclassified,1,0,1
11843,bridge,skyline,crossclassified,1,1,0
11401,die,dog,crossclassified,1,0,1
11400,child,face,co-hyponymy,1,1,0
11906,clock,post,crossclassified,1,1,0
15358,aquarium,shoe,crossclassified,1,1,0
11366,mask,mobile,crossclassified,1,1,0
11367,mask,person,crossclassified,1,1,0
12491,counter,menus,crossclassified,1,1,0
11849,grill,knob,crossclassified,1,1,0
15101,pizza,ship,crossclassified,1,0,1
11399,indoor,window,crossclassified,1,0,1
11398,drapes,window,crossclassified,1,0,1
15807,fish,sandwich,crossclassified,1,1,0
11891,diner,storefront,crossclassified,1,0,1
15089,dress,joystick,crossclassified,1,1,0
15100,coke,pancakes,crossclassified,1,0,1
11405,bar,zebra,crossclassified,1,0,1
15243,cloak,jacket,crossclassified,1,0,1
11841,blender,wire,crossclassified,1,1,0
11411,patio,seating,crossclassified,1,1,0
12445,couch,top,crossclassified,1,1,0
11911,ballplayer,floor,crossclassified,1,0,1
11415,man,zebra,crossclassified,1,1,0
11910,floor,monster,crossclassified,1,1,0
12446,couch,door,crossclassified,1,1,0
11838,bed,corner,crossclassified,1,1,0
15432,bull,goat,co-hyponymy,1,0,1
15360,aquarium,fish,crossclassified,1,1,0
12447,billows,couch,crossclassified,1,0,1
11413,books,cat,crossclassified,1,0,1
11412,dog,pot,crossclassified,1,1,0
11850,bathroom,urinal,crossclassified,1,0,1
15244,railroad,train,crossclassified,1,0,1
12448,cabinet,pervasion,crossclassified,1,1,0
12449,bis,truck,crossclassified,1,0,1
12455,bench,cloth,crossclassified,1,1,0
15104,snowboarder,tress,crossclassified,1,1,0
12451,airplane,wheal,crossclassified,1,1,0
11410,bench,patio,crossclassified,1,0,1
15235,signboard,train,crossclassified,1,0,1
12495,desk,hand,crossclassified,1,1,0
15103,bench,master,crossclassified,1,1,0
15102,liner,ship,hypernymy.2,1,0,1
12453,couch,dogleg,crossclassified,1,1,0
12494,rug,towel,crossclassified,1,1,0
12454,bench,menstruation,crossclassified,1,1,0
15088,bench,slipper,crossclassified,1,1,0
11888,chair,storefront,crossclassified,1,0,1
15436,pirate,suit,crossclassified,1,0,1
11840,bathtub,body,crossclassified,1,1,0
15090,beds,couch,hypernymy.1,1,0,1
15493,man,veggies,crossclassified,1,1,0
11845,cup,knife,crossclassified,1,0,1
15093,bezant,hotdog,crossclassified,1,0,1
11897,light,street,crossclassified,1,0,1
12476,counter,tonsils,crossclassified,1,1,0
15234,grass,plants,hypernymy.2,1,1,0
15096,bed,model,crossclassified,1,1,0
11384,mouse,phone,crossclassified,1,1,0
15092,cower,hotdog,crossclassified,1,0,1
11371,mask,puppet,crossclassified,1,1,0
11846,grill,t-shirt,crossclassified,1,1,0
11383,car,whitecap,crossclassified,1,1,0
15095,truck,veils,crossclassified,1,1,0
12477,carat,counter,crossclassified,1,0,1
15231,garden,grass,crossclassified,1,0,1
15094,class,truck,crossclassified,1,0,1
15356,blazer,man,crossclassified,1,0,1
11896,street,window,crossclassified,1,1,0
11386,mouse,shoe,crossclassified,1,1,0
11372,cellphone,mask,crossclassified,1,0,1
15232,grass,meadow,crossclassified,1,1,0
15373,shop,window,crossclassified,1,0,1
15355,robe,snack,crossclassified,1,1,0
15233,grass,wildflowers,crossclassified,1,1,0
15354,robe,snakes,crossclassified,1,1,0
12480,bed,sign,crossclassified,1,1,0
11893,brochures,table,crossclassified,1,0,1
12483,doors,train,crossclassified,1,0,1
11374,bathtub,box,crossclassified,1,1,0
15372,male,window,crossclassified,1,0,1
11894,airplane,fleet,crossclassified,1,1,0
11376,overpass,train,crossclassified,1,0,1
11378,bridge,pavement,crossclassified,1,1,0
11385,mobile,mouse,crossclassified,1,0,1
15495,foot,shirt,crossclassified,1,0,1
15494,bell,cow,crossclassified,1,0,1
11892,shop,table,crossclassified,1,0,1
11904,clock,lamp,crossclassified,1,1,0
11395,door,portability,crossclassified,1,1,0
12466,counter,pepperoni,crossclassified,1,1,0
15439,boll,dog,crossclassified,1,0,1
12467,coke,counter,crossclassified,1,0,1
15438,boat,sloop,crossclassified,1,1,0
11368,human,mask,crossclassified,1,0,1
11369,mask,phone,crossclassified,1,1,0
12489,cupboard,floor,crossclassified,1,0,1
11393,antelope,goat,co-hyponymy,1,0,1
12488,board,dresser,crossclassified,1,0,1
11370,jacket,mask,crossclassified,1,0,1
12487,dresser,hairdresser,crossclassified,1,1,0
15097,curtain,sunscreen,crossclassified,1,1,0
11900,colander,table,crossclassified,1,0,1
12475,signboard,truck,crossclassified,1,0,1
11899,headlights,street,crossclassified,1,0,1
15357,aquarium,shirt,crossclassified,1,1,0
12485,table,water,crossclassified,1,1,0
15353,table,tickets,crossclassified,1,1,0
12470,chocolate,counter,crossclassified,1,0,1
11848,grill,printer,crossclassified,1,1,0
11389,train,umbellate,crossclassified,1,1,0
12471,plane,wall,crossclassified,1,1,0
12472,couch,placeman,crossclassified,1,1,0
11898,rail,street,crossclassified,1,0,1
12474,advertisement,truck,crossclassified,1,0,1
11388,mouse,telephone,crossclassified,1,1,0
11387,mouse,wire,crossclassified,1,1,0
12484,bicycle,scooter,co-hyponymy,1,0,1
11416,bed,reflection,crossclassified,1,1,0
11851,urinal,urinals,synonymy,1,1,0
15443,car,phone,crossclassified,1,1,0
11437,drawing,train,crossclassified,1,0,1
11361,net,table,crossclassified,1,0,1
12505,bench,sweatshirt,crossclassified,1,1,0
12418,desk,yosemite,crossclassified,1,1,0
15087,equipment,glove,hypernymy.1,1,0,1
12417,plane,spacecraft,crossclassified,1,1,0
11832,chair,drink,crossclassified,1,1,0
11856,floor,things,crossclassified,1,1,0
12444,couch,ring,crossclassified,1,1,0
15380,set,skateboarder,crossclassified,1,0,1
15490,pastureland,sheep,crossclassified,1,0,1
11831,truck,vedic,crossclassified,1,1,0
15430,controllerships,woman,crossclassified,1,0,1
11929,couch,garbage,crossclassified,1,1,0
15114,bridge,brits,crossclassified,1,1,0
15341,pool,water,hypernymy.2,1,1,0
12419,airbus,plane,hypernymy.2,1,0,1
11928,bin,couch,crossclassified,1,0,1
15379,baby,hand,crossclassified,1,1,0
15342,pool,skateboarder,crossclassified,1,1,0
11435,paint,train,crossclassified,1,0,1
11833,counter,muffins,crossclassified,1,1,0
15343,pool,wheel,crossclassified,1,1,0
12504,freight,train,crossclassified,1,0,1
11433,hat,train,crossclassified,1,0,1
12420,bedroom,couch,crossclassified,1,0,1
15496,lunch,shirt,crossclassified,1,0,1
15431,curtain,student,crossclassified,1,1,0
15344,dog,harness,co-hyponymy,1,1,0
15345,barricade,bridge,crossclassified,1,0,1
15228,grass,tree,crossclassified,1,1,0
12423,phone,van,crossclassified,1,0,1
11439,fork,rug,crossclassified,1,0,1
11359,boat,gonadal,crossclassified,1,1,0
12415,train,watch,crossclassified,1,1,0
12482,tire,vehicle,crossclassified,1,1,0
12406,stone,table,crossclassified,1,0,1
12407,craft,table,crossclassified,1,0,1
12408,frosting,table,crossclassified,1,0,1
11936,pipe,toilet,crossclassified,1,0,1
11445,person,pool,crossclassified,1,1,0
12409,fisherman,table,crossclassified,1,0,1
11356,giraffe,tarp,crossclassified,1,1,0
12410,parachute,t-shirt,crossclassified,1,1,0
15497,boat,shine,crossclassified,1,1,0
15339,ledge,pool,crossclassified,1,0,1
11826,bowl,souffle,crossclassified,1,1,0
11934,shower,toilet,co-hyponymy,1,0,1
11933,floor,mouse,crossclassified,1,1,0
15340,pool,swimming,crossclassified,1,1,0
11442,giraffe,goat,crossclassified,1,1,0
12506,boat,stone,crossclassified,1,1,0
15489,desk,plant,crossclassified,1,1,0
15442,man,rises,crossclassified,1,1,0
11932,table,toaster,crossclassified,1,1,0
11441,rug,stand,crossclassified,1,1,0
15441,desk,reported,crossclassified,1,1,0
11827,bookshelves,cabinet,crossclassified,1,0,1
11884,curtain,storefront,crossclassified,1,0,1
11828,glass,scooter,crossclassified,1,0,1
11357,covering,giraffe,crossclassified,1,0,1
11829,mirror,scooter,crossclassified,1,0,1
12414,cabinets,desk,crossclassified,1,0,1
11930,bridge,lights,crossclassified,1,1,0
12507,boat,dove,crossclassified,1,1,0
15429,fresh,jacket,crossclassified,1,0,1
12424,cellphone,van,crossclassified,1,0,1
15113,bridge,tern,crossclassified,1,1,0
12425,bench,van,crossclassified,1,0,1
12498,boat,player,crossclassified,1,1,0
12435,machines,plane,hypernymy.1,1,0,1
15110,coat,shirts,crossclassified,1,1,0
11918,camera,lamp,crossclassified,1,0,1
11973,boat,fireboat,hypernymy.1,1,1,0
11917,bridge,stairs,co-hyponymy,1,1,0
11425,hares,zebra,crossclassified,1,0,1
15109,class,coat,crossclassified,1,0,1
15108,track,woman,crossclassified,1,0,1
11916,bridge,staircase,crossclassified,1,1,0
11422,fork,scoop,crossclassified,1,1,0
12499,box,bun,crossclassified,1,1,0
11836,bed,vase,crossclassified,1,1,0
11420,bowl,giraffe,crossclassified,1,0,1
15107,cabinet,pizza,crossclassified,1,1,0
15362,storefront,table,crossclassified,1,0,1
15805,fish,snacks,crossclassified,1,1,0
11419,plank,table,crossclassified,1,0,1
12438,calender,counter,crossclassified,1,0,1
15242,tub,wassermann,crossclassified,1,1,0
12497,baseball,boat,crossclassified,1,0,1
11915,bridge,crosswalk,crossclassified,1,1,0
11914,bridge,steps,co-hyponymy,1,1,0
12496,floor,star,crossclassified,1,1,0
12439,tile,window,crossclassified,1,0,1
12440,plane,uniforms,crossclassified,1,1,0
15106,boat,store,crossclassified,1,1,0
12442,men,plane,crossclassified,1,0,1
11913,boots,carpet,crossclassified,1,0,1
12443,group,plane,crossclassified,1,0,1
15361,aquarium,fishes,crossclassified,1,1,0
12434,gadget,plane,crossclassified,1,0,1
12433,counter,milk,crossclassified,1,1,0
15364,chelate,dog,crossclassified,1,0,1
15434,parachute,woman,crossclassified,1,0,1
12503,box,plate,co-hyponymy,1,1,0
12502,box,container,hypernymy.2,1,1,0
11854,boat,housing,crossclassified,1,1,0
15346,bridge,clothing,crossclassified,1,1,0
15229,grass,trepan,crossclassified,1,1,0
15112,horse,rein,crossclassified,1,1,0
12501,box,floor,crossclassified,1,1,0
11432,airplane,bat,crossclassified,1,1,0
11431,furniture,pot,crossclassified,1,0,1
15230,grass,land,crossclassified,1,1,0
15347,bridge,skateboard,crossclassified,1,1,0
15363,cruiser,ship,hypernymy.2,1,0,1
12427,couch,upholstery,crossclassified,1,1,0
11924,counter,sweater,co-hyponymy,1,1,0
11429,bridge,sky,crossclassified,1,1,0
11426,curtain,system,crossclassified,1,1,0
11428,dog,utensils,crossclassified,1,1,0
15111,bats,man,crossclassified,1,0,1
12430,chair,sheet,crossclassified,1,1,0
12431,counter,unclear,crossclassified,1,1,0
11364,dress,mask,hypernymy.1,1,0,1
15378,baby,brash,crossclassified,1,1,0
15236,building,condos,crossclassified,1,1,0
11922,bathroom,bidet,crossclassified,1,0,1
12432,counter,curtain,crossclassified,1,1,0
11427,curtain,electronic,crossclassified,1,1,0
11921,bidet,tile,crossclassified,1,1,0
11920,bidet,lateen,crossclassified,1,1,0
15377,baby,knife,crossclassified,1,1,0
15376,baby,fess,crossclassified,1,1,0
12437,couch,shelf,crossclassified,1,1,0
12097,boat,shirts,crossclassified,1,1,0
15391,cap,wall,crossclassified,1,0,1
11744,oven,tile,crossclassified,1,1,0
11642,fridge,oven,crossclassified,1,0,1
15268,fence,post,crossclassified,1,1,0
11740,ear,man,crossclassified,1,0,1
11643,oven,tray,crossclassified,1,1,0
12057,meeting,rug,crossclassified,1,0,1
12189,bed,headphone,crossclassified,1,1,0
15416,building,concrete,crossclassified,1,1,0
11644,light,van,crossclassified,1,0,1
12188,bed,gear,crossclassified,1,1,0
12187,accessories,bed,crossclassified,1,0,1
12058,floor,rocker,crossclassified,1,1,0
15408,carpet,ribbon,crossclassified,1,1,0
12186,playlet,train,crossclassified,1,0,1
12185,table,trellis,crossclassified,1,1,0
11738,dugout,umbrella,crossclassified,1,1,0
15290,curtain,mate,crossclassified,1,1,0
12184,rail,table,crossclassified,1,0,1
15206,building,tie,crossclassified,1,1,0
12191,curtain,salad,crossclassified,1,1,0
12056,mouse,rug,crossclassified,1,0,1
15174,bun,couch,crossclassified,1,0,1
11637,mirror,oven,crossclassified,1,0,1
15292,boy,midget,crossclassified,1,1,0
15291,shirt,souvenir,crossclassified,1,1,0
15450,basin,bowl,co-hyponymy,1,0,1
15207,building,skyscraper,hypernymy.1,1,1,0
12053,scooter,trotting,crossclassified,1,1,0
12196,counter,salad,crossclassified,1,1,0
15405,building,fabric,crossclassified,1,1,0
12055,bat,scooter,crossclassified,1,0,1
12195,table,wrapper,crossclassified,1,1,0
15406,carpet,showroom,crossclassified,1,1,0
12194,table,wiener,crossclassified,1,1,0
12054,scooter,skateboard,co-hyponymy,1,1,0
12193,foil,table,crossclassified,1,0,1
12192,curtain,pear,crossclassified,1,1,0
15407,carpet,store,crossclassified,1,1,0
12183,handles,table,crossclassified,1,0,1
15464,train,trainer,crossclassified,1,1,0
11646,airplane,surfer,crossclassified,1,0,1
11656,criminal,man,crossclassified,1,0,1
15202,bowl,meatballs,crossclassified,1,1,0
12176,table,tin,crossclassified,1,1,0
11732,curtain,gown,crossclassified,1,1,0
15179,badge,toy,crossclassified,1,0,1
15463,cat,leg,crossclassified,1,1,0
15451,curtain,tael,crossclassified,1,1,0
15414,building,yard,crossclassified,1,1,0
15272,bottle,pop,crossclassified,1,1,0
11734,kite,tent,crossclassified,1,0,1
15180,tag,toy,crossclassified,1,0,1
12064,couch,den,crossclassified,1,1,0
15288,broth,cup,crossclassified,1,0,1
11658,headset,table,crossclassified,1,0,1
15181,horn,sheep,crossclassified,1,0,1
12065,counter,sofa,crossclassified,1,1,0
12174,bus,suv,co-hyponymy,1,0,1
11733,curtain,groom,crossclassified,1,1,0
11654,man,pool,crossclassified,1,1,0
15177,sticker,toy,crossclassified,1,0,1
12181,animal,window,crossclassified,1,0,1
11737,bathroom,woman,crossclassified,1,0,1
12059,tire,van,crossclassified,1,0,1
15204,building,lamb,crossclassified,1,1,0
15415,alley,building,crossclassified,1,0,1
15203,bowl,vagabond,crossclassified,1,1,0
11736,soap,woman,crossclassified,1,0,1
11648,chair,latch,crossclassified,1,1,0
11649,chair,cushion,crossclassified,1,1,0
15271,fence,jump,crossclassified,1,1,0
11650,cabinet,support,crossclassified,1,1,0
12180,kid,motorcycle,crossclassified,1,0,1
12061,floor,frame,crossclassified,1,1,0
15409,button,man,crossclassified,1,0,1
11652,bed,leg,crossclassified,1,1,0
15270,bar,fence,crossclassified,1,0,1
15289,controller,girl,crossclassified,1,0,1
15266,board,fence,crossclassified,1,0,1
15418,building,pant,crossclassified,1,1,0
15182,ear,giraffe,crossclassified,1,0,1
15208,airplane,woman,crossclassified,1,0,1
11627,chain,floor,crossclassified,1,0,1
11628,exhibit,floor,crossclassified,1,0,1
12227,semitrailer,train,crossclassified,1,0,1
12036,couch,pets,crossclassified,1,1,0
12226,counter,tableware,crossclassified,1,1,0
15448,pit,truck,crossclassified,1,0,1
12225,counter,veggies,crossclassified,1,1,0
12224,mission,table,crossclassified,1,0,1
12223,floor,reflection,crossclassified,1,1,0
15169,counter,washerwomen,crossclassified,1,1,0
12222,dresser,floor,crossclassified,1,0,1
15170,bench,drinks,crossclassified,1,1,0
11751,bow,couch,crossclassified,1,0,1
12221,bench,chickadee,crossclassified,1,1,0
12220,chili,counter,crossclassified,1,0,1
12038,rack,vanity,crossclassified,1,0,1
12039,furniture,vanity,hypernymy.1,1,0,1
12034,monitor,truck,crossclassified,1,0,1
12230,chiffonier,counter,crossclassified,1,0,1
12231,electronics,floor,crossclassified,1,0,1
12235,sea,ship,crossclassified,1,0,1
15167,counter,passionflowers,crossclassified,1,1,0
15212,boat,pilot,crossclassified,1,1,0
11871,cushion,floor,crossclassified,1,0,1
15295,banian,bowl,crossclassified,1,0,1
11621,chair,shirts,crossclassified,1,1,0
11622,chair,scissor,crossclassified,1,1,0
12236,military,ship,crossclassified,1,0,1
11623,chair,crafts,crossclassified,1,1,0
15168,counter,hotel,crossclassified,1,1,0
15465,bench,tack,crossclassified,1,1,0
15802,cat,cave,crossclassified,1,1,0
12234,harry,motorcycle,crossclassified,1,0,1
15402,building,plantains,crossclassified,1,1,0
12233,shoe,van,crossclassified,1,0,1
12232,comfortable,couch,crossclassified,1,0,1
11624,house,tress,crossclassified,1,1,0
12040,tray,truck,crossclassified,1,0,1
12218,calcium,counter,crossclassified,1,0,1
12041,shelf,truck,crossclassified,1,0,1
15801,girls,woman,hypernymy.2,1,0,1
12205,chair,tree,crossclassified,1,1,0
11748,bench,tennis,crossclassified,1,1,0
12048,curtain,tiles,crossclassified,1,1,0
11631,bench,newspaper,crossclassified,1,1,0
12203,chassis,motorcycle,crossclassified,1,0,1
12049,curtain,floor,crossclassified,1,1,0
12050,actress,curtain,crossclassified,1,0,1
12051,curtain,umbrella,crossclassified,1,1,0
11749,helicopter,train,crossclassified,1,1,0
12202,boat,dash,crossclassified,1,1,0
11747,auto,truck,co-hyponymy,1,0,1
15812,catch,woman,co-hyponymy,1,0,1
15419,building,player,crossclassified,1,1,0
11634,oven,system,crossclassified,1,1,0
11746,cabinetry,oven,crossclassified,1,0,1
11636,bench,oven,crossclassified,1,0,1
12206,boat,launch,hypernymy.1,1,1,0
15210,appliance,plane,crossclassified,1,0,1
12217,counter,healthy,crossclassified,1,1,0
12214,boat,room,crossclassified,1,1,0
12216,counter,groceries,crossclassified,1,1,0
15293,lady,surfer,crossclassified,1,0,1
15265,fence,wool,crossclassified,1,1,0
15449,batter,truck,crossclassified,1,0,1
15403,building,stall,crossclassified,1,1,0
12044,arm,bed,crossclassified,1,0,1
11630,floor,poor,crossclassified,1,1,0
12213,meatpacking,table,crossclassified,1,0,1
15171,chinookan,couch,crossclassified,1,0,1
12212,furniture,girls,crossclassified,1,1,0
12211,child,furniture,crossclassified,1,0,1
12210,furniture,person,crossclassified,1,1,0
15404,building,towel,crossclassified,1,1,0
12209,dachshund,furniture,crossclassified,1,0,1
12208,furniture,wheel,crossclassified,1,1,0
12045,bed,biscuit,crossclassified,1,1,0
15462,couch,hire,crossclassified,1,1,0
12172,cover,curtain,crossclassified,1,0,1
11619,shelf,things,crossclassified,1,1,0
15276,bench,eggs,crossclassified,1,1,0
12121,bench,boot,crossclassified,1,1,0
12086,airplane,laptop,crossclassified,1,1,0
12087,boat,mountain,crossclassified,1,1,0
11690,bed,coolers,crossclassified,1,1,0
12088,boat,leg,crossclassified,1,1,0
15453,cat,piano,crossclassified,1,1,0
11691,table,workstation,crossclassified,1,1,0
15192,bulgur,meat,crossclassified,1,0,1
12116,bar,mantle,crossclassified,1,1,0
12115,bar,cup,crossclassified,1,1,0
11692,tin,woman,crossclassified,1,0,1
15193,meat,mutton,hypernymy.1,1,1,0
12089,shelf,t-shirt,crossclassified,1,1,0
15282,ire,pot,crossclassified,1,0,1
15278,ladder,truck,crossclassified,1,0,1
15455,floor,remote,crossclassified,1,1,0
11694,desk,piano,crossclassified,1,1,0
11688,counter,utensils,crossclassified,1,1,0
11687,floor,upstairs,crossclassified,1,1,0
15277,bench,shoes,crossclassified,1,1,0
15456,boat,hopes,crossclassified,1,1,0
11679,produce,table,crossclassified,1,0,1
15199,bridge,trepan,crossclassified,1,1,0
11680,mango,table,crossclassified,1,0,1
15457,counter,lite,crossclassified,1,1,0
15191,face,vantage,crossclassified,1,1,0
12131,curtain,top,crossclassified,1,1,0
12130,bed,headset,crossclassified,1,1,0
11681,blade,rug,crossclassified,1,0,1
12122,bench,bleachers,crossclassified,1,1,0
12128,couch,fork,crossclassified,1,1,0
15283,girl,snack,crossclassified,1,1,0
12126,people,plane,crossclassified,1,0,1
11683,cabinet,monitor,crossclassified,1,1,0
12084,boat,pizza,crossclassified,1,1,0
12125,dress,plane,crossclassified,1,0,1
12123,sink,tray,crossclassified,1,1,0
11695,blender,drink,crossclassified,1,1,0
11696,curtain,shirts,crossclassified,1,1,0
12109,airplane,transatlantic,crossclassified,1,1,0
15197,class,motorcycle,crossclassified,1,0,1
11704,motorcycle,salad,crossclassified,1,1,0
15280,doughnuts,man,crossclassified,1,0,1
12093,cloth,shelf,crossclassified,1,0,1
11709,floor,umbrella,crossclassified,1,1,0
15279,jam,man,crossclassified,1,0,1
15196,airplane,planetesimal,crossclassified,1,1,0
12095,board,curtain,crossclassified,1,0,1
12096,bed,motel,crossclassified,1,1,0
11717,innards,woman,crossclassified,1,0,1
11710,cloth,face,crossclassified,1,0,1
15454,man,outfielder,crossclassified,1,1,0
11711,face,glass,crossclassified,1,1,0
11712,face,tie,crossclassified,1,1,0
11715,table,vessel,crossclassified,1,1,0
11714,face,hair,crossclassified,1,1,0
12099,couch,robe,crossclassified,1,1,0
12100,box,boxberry,crossclassified,1,1,0
11703,desk,drink,crossclassified,1,1,0
12108,boat,canadian,crossclassified,1,1,0
12104,plane,windshield,crossclassified,1,1,0
15281,girl,writing,crossclassified,1,1,0
11697,curtain,ring,crossclassified,1,1,0
12090,girl,shelf,crossclassified,1,0,1
12107,cabinet,curio,crossclassified,1,1,0
12106,floor,zipper,crossclassified,1,1,0
15194,couch,mope,crossclassified,1,1,0
11698,curtain,human,crossclassified,1,1,0
12103,plane,window,crossclassified,1,1,0
15195,aerial,airplane,crossclassified,1,0,1
11699,curtain,gamer,crossclassified,1,1,0
11718,scooter,shirt,crossclassified,1,1,0
11700,curtain,sleeve,crossclassified,1,1,0
12102,box,sweet,crossclassified,1,1,0
11702,desk,tin,crossclassified,1,1,0
12091,cubby,shelf,crossclassified,1,0,1
12101,box,dessert,crossclassified,1,1,0
11720,dog,scooter,crossclassified,1,0,1
12133,route,table,crossclassified,1,0,1
11730,floor,mate,crossclassified,1,1,0
12083,bookshelf,rack,crossclassified,1,1,0
11665,shirts,skater,crossclassified,1,0,1
11727,bowl,bun,crossclassified,1,1,0
11666,bench,mirror,crossclassified,1,1,0
11726,bed,sample,crossclassified,1,1,0
12069,furniture,tiles,crossclassified,1,1,0
11667,curtain,shades,crossclassified,1,1,0
12161,sofa,tile,crossclassified,1,1,0
12160,elephant,truck,crossclassified,1,0,1
15184,bat,playing,crossclassified,1,1,0
11669,creepy,man,crossclassified,1,0,1
15410,truck,vesicle,crossclassified,1,1,0
12071,furniture,livingstone,crossclassified,1,1,0
15185,bat,t-shirt,crossclassified,1,1,0
15816,guy,pants,crossclassified,1,0,1
12158,basket,chair,crossclassified,1,0,1
12072,frisbee,table,crossclassified,1,0,1
11725,plant,table,crossclassified,1,0,1
15285,dog,toilet,crossclassified,1,1,0
15200,dog,ornament,crossclassified,1,1,0
12164,curtain,people,crossclassified,1,1,0
11661,floor,girl,crossclassified,1,0,1
11660,coolers,woman,crossclassified,1,0,1
11729,floor,skirt,crossclassified,1,1,0
11728,bowl,sweatbox,crossclassified,1,1,0
12066,counter,griddle,crossclassified,1,1,0
12067,bed,magazine,crossclassified,1,1,0
15183,cabinet,cubbyhole,crossclassified,1,1,0
12170,bedspread,couch,crossclassified,1,0,1
15201,dog,malformation,crossclassified,1,1,0
12165,couple,curtain,crossclassified,1,0,1
12168,chair,ties,crossclassified,1,1,0
15287,stone,train,crossclassified,1,0,1
11663,care,desk,crossclassified,1,0,1
12167,casters,rug,crossclassified,1,0,1
15286,hole,train,crossclassified,1,0,1
12068,furniture,mat,crossclassified,1,1,0
12166,rug,stem,crossclassified,1,1,0
15186,bat,cap,crossclassified,1,1,0
15815,athlete,pants,crossclassified,1,0,1
15187,bat,team,crossclassified,1,1,0
15275,castle,church,crossclassified,1,0,1
12140,highchair,wood,crossclassified,1,1,0
11722,counter,flowerpot,crossclassified,1,1,0
12078,bikers,motorcycle,crossclassified,1,0,1
15413,building,cement,crossclassified,1,1,0
12079,bench,bush,crossclassified,1,1,0
12080,bench,motorcycle,crossclassified,1,0,1
15274,church,window,crossclassified,1,1,0
12137,motorcycle,tires,crossclassified,1,1,0
12141,brush,highchair,crossclassified,1,0,1
15459,skateboarder,tree,crossclassified,1,1,0
11678,architecture,building,hypernymy.2,1,0,1
15452,cat,class,crossclassified,1,1,0
15458,locket,table,crossclassified,1,0,1
12082,bed,tray,crossclassified,1,1,0
15190,face,os,crossclassified,1,1,0
12134,children,motorcycle,crossclassified,1,0,1
11673,braids,girl,crossclassified,1,0,1
15189,face,hire,crossclassified,1,1,0
11670,cabinet,doors,crossclassified,1,1,0
12150,hydrant,ship,crossclassified,1,0,1
12155,car,rope,crossclassified,1,1,0
12074,bookshelf,dress,crossclassified,1,1,0
12154,cat,tile,crossclassified,1,1,0
12075,bookshelf,students,crossclassified,1,1,0
11671,car,cartilage,crossclassified,1,1,0
12152,aegean,bench,crossclassified,1,0,1
12151,trial,truck,crossclassified,1,0,1
12076,bookshelf,plate,crossclassified,1,1,0
15460,horse,rhino,crossclassified,1,1,0
15461,shirt,tin,crossclassified,1,1,0
12148,bench,wire,crossclassified,1,1,0
12147,bench,flowerpot,crossclassified,1,1,0
12077,bookshelf,cake,crossclassified,1,1,0
11723,dinner,knife,crossclassified,1,0,1
15284,girl,pastry,crossclassified,1,1,0
12144,girl,highchair,crossclassified,1,0,1
11620,shelf,showcase,crossclassified,1,1,0
15166,counter,waking,crossclassified,1,1,0
11501,desk,drawing,crossclassified,1,1,0
11784,patio,porch,crossclassified,1,1,0
15316,child,tress,crossclassified,1,1,0
11992,alabaster,vase,crossclassified,1,0,1
15314,cabinet,copolymer,crossclassified,1,1,0
11539,cup,pyrex,crossclassified,1,1,0
15143,bear,cow,crossclassified,1,0,1
15144,boot,cow,crossclassified,1,0,1
11779,telescope,woman,crossclassified,1,0,1
15259,house,mane,crossclassified,1,1,0
12317,icebreaker,table,crossclassified,1,0,1
12316,petals,table,crossclassified,1,0,1
11995,bird,tide,crossclassified,1,1,0
12315,desk,guy,crossclassified,1,1,0
12314,desk,worker,crossclassified,1,1,0
11541,footrest,rug,crossclassified,1,0,1
11542,bedfellow,cow,crossclassified,1,0,1
12313,train,transit,crossclassified,1,1,0
15313,counter,nigh,crossclassified,1,1,0
11780,hippy,woman,crossclassified,1,0,1
15317,child,handclasps,crossclassified,1,1,0
11781,things,woman,crossclassified,1,0,1
15809,cat,eyeglass,crossclassified,1,1,0
11988,hydrant,tent,crossclassified,1,0,1
11989,store,tent,crossclassified,1,0,1
11990,snot,tent,crossclassified,1,0,1
11533,hutch,vase,crossclassified,1,0,1
11534,bureau,vase,crossclassified,1,0,1
12321,bench,sandal,crossclassified,1,1,0
15396,ire,train,crossclassified,1,0,1
15137,hair,skateboarder,crossclassified,1,0,1
11535,shelving,vase,crossclassified,1,0,1
15138,dress,underclothing,crossclassified,1,1,0
15139,dress,glows,crossclassified,1,1,0
15140,chair,pots,crossclassified,1,1,0
15257,boy,glows,crossclassified,1,1,0
15141,chair,spoon,crossclassified,1,1,0
11991,boat,tanker,crossclassified,1,1,0
15258,boy,sportsman,crossclassified,1,1,0
15312,handle,vase,crossclassified,1,0,1
12312,bottle,shelving,crossclassified,1,1,0
15145,birds,skier,crossclassified,1,0,1
12301,propeller,wings,crossclassified,1,1,0
12304,airplane,turbine,crossclassified,1,1,0
15473,bezant,woman,crossclassified,1,0,1
11775,player,shed,crossclassified,1,0,1
11556,bridge,tell,crossclassified,1,1,0
11557,bridge,seedcase,crossclassified,1,1,0
12303,propeller,turboprop,crossclassified,1,1,0
11774,cap,shed,crossclassified,1,0,1
15147,skateboarder,skier,crossclassified,1,0,1
15474,sign,total,crossclassified,1,1,0
11559,bridge,chain,crossclassified,1,1,0
11560,bridge,smile,crossclassified,1,1,0
15309,belt,couch,crossclassified,1,0,1
12299,cloth,suitcase,crossclassified,1,0,1
12298,truck,vegetable,crossclassified,1,1,0
12297,bench,jean,crossclassified,1,1,0
11773,shed,tennis,crossclassified,1,1,0
11554,lap,person,crossclassified,1,0,1
15310,vase,wood,crossclassified,1,1,0
12311,bottle,furniture,crossclassified,1,1,0
11549,boat,veritable,crossclassified,1,1,0
11997,bird,naira,crossclassified,1,1,0
11545,dog,pup,crossclassified,1,1,0
11777,carpet,trash,crossclassified,1,1,0
11547,boat,veggies,crossclassified,1,1,0
12310,bottle,hutch,crossclassified,1,1,0
15476,sign,wall,crossclassified,1,1,0
11998,bird,wave,crossclassified,1,1,0
15426,dugout,human,crossclassified,1,1,0
12305,bed,sofas,crossclassified,1,1,0
15475,sign,storefront,crossclassified,1,1,0
15397,child,sea,crossclassified,1,1,0
11776,cat,cushion,crossclassified,1,1,0
11999,china,vase,crossclassified,1,0,1
15311,picture,vase,crossclassified,1,0,1
12307,motorcycle,poster,crossclassified,1,1,0
12306,jelly,table,crossclassified,1,0,1
12323,carpet,dresser,crossclassified,1,1,0
11987,tent,wood,crossclassified,1,1,0
11561,bridge,woman,crossclassified,1,1,0
11531,vanity,vase,crossclassified,1,0,1
11513,display,showcase,crossclassified,1,1,0
12342,couch,pyjamas,crossclassified,1,1,0
15325,tie,top,crossclassified,1,1,0
11979,airplane,mitchell,crossclassified,1,1,0
15481,curtain,mat,crossclassified,1,1,0
11514,display,trophy,crossclassified,1,1,0
15131,mat,sofa,crossclassified,1,0,1
11515,display,photo,co-hyponymy,1,1,0
12341,mirror,road,crossclassified,1,1,0
12340,bike,mirror,crossclassified,1,0,1
11516,baseball,display,crossclassified,1,0,1
11517,display,frame,crossclassified,1,1,0
11518,bat,display,crossclassified,1,0,1
11519,cup,flower,crossclassified,1,1,0
15799,car,sparrow,crossclassified,1,1,0
15480,curtain,teal,crossclassified,1,1,0
15324,tie,uniform,crossclassified,1,1,0
12343,boat,snow,crossclassified,1,1,0
11512,display,tile,crossclassified,1,1,0
11978,floor,skating,crossclassified,1,1,0
15255,house,pot,crossclassified,1,1,0
11975,bowl,sauerkraut,crossclassified,1,1,0
15221,chair,room,crossclassified,1,1,0
15482,horse,rear,crossclassified,1,1,0
15328,jacket,projector,crossclassified,1,1,0
12346,chair,note,crossclassified,1,1,0
15327,jacket,lens,crossclassified,1,1,0
11503,display,sign,co-hyponymy,1,1,0
12345,chair,pen,crossclassified,1,1,0
11510,display,plaque,crossclassified,1,1,0
11504,book,display,crossclassified,1,0,1
11505,display,monitor,hypernymy.1,1,1,0
11506,display,gift,crossclassified,1,1,0
15392,motor,wall,crossclassified,1,0,1
12344,appetizers,table,crossclassified,1,0,1
11508,display,furniture,crossclassified,1,1,0
11509,display,shadowbox,crossclassified,1,1,0
11520,bus,camper,crossclassified,1,1,0
11788,courtyard,patio,co-hyponymy,1,0,1
15132,bed,picture,crossclassified,1,1,0
12325,clock,stand,crossclassified,1,0,1
11527,apple,van,crossclassified,1,0,1
12326,rack,stand,synonymy,1,0,1
11786,patio,room,co-hyponymy,1,1,0
11529,banana,van,crossclassified,1,0,1
15134,house,rope,crossclassified,1,1,0
15393,person,wall,crossclassified,1,0,1
11785,decor,patio,crossclassified,1,0,1
12324,carpet,drawer,crossclassified,1,1,0
11984,helmet,kayak,crossclassified,1,0,1
11985,tent,wotan,crossclassified,1,1,0
15395,office,shirt,crossclassified,1,0,1
15135,boy,piano,crossclassified,1,1,0
15321,fork,snack,crossclassified,1,1,0
15136,boy,music,crossclassified,1,1,0
15220,building,chain,crossclassified,1,1,0
15477,jacket,tree,crossclassified,1,1,0
12327,entertainment,stand,crossclassified,1,0,1
12098,motorcycle,wood,crossclassified,1,1,0
12337,bathroom,mirror,crossclassified,1,0,1
11980,kayak,sea,crossclassified,1,1,0
11521,dog,god,crossclassified,1,1,0
12335,lateen,mirror,crossclassified,1,0,1
15256,garden,house,crossclassified,1,0,1
15479,doberman,dog,hypernymy.2,1,0,1
12334,animals,grass,crossclassified,1,0,1
12333,coco,grass,crossclassified,1,0,1
15478,banana,bird,crossclassified,1,0,1
15322,cot,couch,co-hyponymy,1,0,1
11983,kayak,raft,crossclassified,1,1,0
15133,house,lap,crossclassified,1,1,0
11523,button,counter,crossclassified,1,0,1
11524,counter,stick,crossclassified,1,1,0
11525,smiling,woman,crossclassified,1,0,1
11787,ground,patio,crossclassified,1,0,1
12329,console,stand,co-hyponymy,1,0,1
11982,belt,kayak,crossclassified,1,0,1
15308,bed,jeans,crossclassified,1,1,0
11562,bridge,hair,crossclassified,1,1,0
11618,shelf,vessels,crossclassified,1,1,0
11590,aquarium,headboard,crossclassified,1,1,0
15300,bookshelf,woman,crossclassified,1,1,0
12257,table,tarp,crossclassified,1,1,0
12256,couch,tuxedo,crossclassified,1,1,0
12255,couch,court,crossclassified,1,1,0
12021,buggy,cart,crossclassified,1,0,1
15157,jockey,tent,crossclassified,1,0,1
11600,pool,woman,crossclassified,1,0,1
12253,couch,shoebox,crossclassified,1,1,0
12252,couch,system,crossclassified,1,1,0
15158,hat,towel,crossclassified,1,1,0
12250,chair,paw,crossclassified,1,1,0
15159,bed,embroidery,crossclassified,1,1,0
11758,drawer,wardrobe,crossclassified,1,0,1
15468,television,woman,crossclassified,1,0,1
11601,couch,trimmer,crossclassified,1,1,0
12023,cart,strap,crossclassified,1,1,0
15421,cat,specs,crossclassified,1,1,0
11759,furniture,wardrobe,hypernymy.1,1,0,1
11597,plane,water,crossclassified,1,1,0
12258,bakery,table,crossclassified,1,0,1
15301,bird,pro,crossclassified,1,1,0
11764,couch,wicker,crossclassified,1,1,0
15153,car,coupe,hypernymy.1,1,1,0
11763,rug,snout,crossclassified,1,1,0
12264,carrot,desk,crossclassified,1,0,1
12263,family,motorcycle,crossclassified,1,0,1
12262,sink,wire,crossclassified,1,1,0
11591,aquarium,furniture,crossclassified,1,1,0
11592,boat,top,crossclassified,1,1,0
15422,cabinet,peppers,crossclassified,1,1,0
12261,airplane,transportation,crossclassified,1,1,0
12259,stripes,table,crossclassified,1,0,1
15469,charcuterie,desk,crossclassified,1,0,1
11594,pot,trash,crossclassified,1,1,0
12019,cart,load,crossclassified,1,1,0
11595,leg,rug,crossclassified,1,0,1
11596,foreleg,rug,crossclassified,1,0,1
12248,chair,frame,crossclassified,1,1,0
15810,fish,pan,crossclassified,1,0,1
15467,tinamou,woman,crossclassified,1,0,1
11614,mixer,shelf,crossclassified,1,0,1
15296,baby,sink,crossclassified,1,0,1
11756,wardrobe,wood,crossclassified,1,1,0
11613,mug,shelf,crossclassified,1,0,1
12243,brush,floor,crossclassified,1,0,1
12242,bed,boxes,crossclassified,1,1,0
12241,bed,sink,co-hyponymy,1,0,1
11755,pillow,wardrobe,crossclassified,1,0,1
15163,bare,woman,crossclassified,1,0,1
11610,table,tools,crossclassified,1,1,0
12239,car,fencing,crossclassified,1,1,0
11615,shelf,stove,crossclassified,1,1,0
15164,beer,woman,crossclassified,1,0,1
15420,building,planter,crossclassified,1,1,0
15165,coloring,woman,crossclassified,1,0,1
11616,shelf,storage,crossclassified,1,1,0
12032,knife,pepperoni,crossclassified,1,1,0
11611,shelf,utensils,crossclassified,1,1,0
12029,arches,bridge,co-hyponymy,1,0,1
11602,charger,couch,crossclassified,1,0,1
11606,car,redcap,crossclassified,1,1,0
15811,cup,dog,crossclassified,1,0,1
11604,chair,salad,crossclassified,1,1,0
12247,floor,toothbrush,crossclassified,1,1,0
12246,floor,screen,crossclassified,1,1,0
15160,person,umbrella,crossclassified,1,1,0
15161,cumberland,person,crossclassified,1,0,1
11605,tracer,truck,crossclassified,1,0,1
15399,banana,building,crossclassified,1,0,1
15213,colors,man,crossclassified,1,0,1
11608,box,suitcase,crossclassified,1,0,1
12024,cart,tyre,crossclassified,1,1,0
11609,suitcase,woodcarver,crossclassified,1,1,0
15162,hairs,woman,crossclassified,1,0,1
12025,cart,things,crossclassified,1,1,0
15214,bird,t-shirt,crossclassified,1,1,0
15400,building,sheet,crossclassified,1,1,0
12266,boat,sing,crossclassified,1,1,0
11589,aquarium,backboard,crossclassified,1,1,0
11563,dugout,gloves,crossclassified,1,1,0
15470,counter,washerwoman,crossclassified,1,1,0
11569,skier,snowflake,crossclassified,1,1,0
15800,girl,skating,crossclassified,1,1,0
11570,coke,woman,crossclassified,1,0,1
15424,cabinet,sillies,crossclassified,1,1,0
11771,shed,t-shirt,crossclassified,1,1,0
11770,bat,shed,crossclassified,1,0,1
12008,boat,see,crossclassified,1,1,0
11572,curtain,shelf,crossclassified,1,1,0
12286,chips,desk,crossclassified,1,0,1
12285,car,mustang,crossclassified,1,1,0
15307,bowl,salsa,crossclassified,1,1,0
15306,knife,robe,crossclassified,1,0,1
15261,headset,jacket,crossclassified,1,0,1
12284,pants,truck,crossclassified,1,0,1
15305,robe,sweater,co-hyponymy,1,1,0
15217,filled,plane,crossclassified,1,0,1
11576,chair,greybeard,crossclassified,1,1,0
12287,cabinet,people,crossclassified,1,1,0
12006,bathtub,latinate,crossclassified,1,1,0
12005,bus,ship,crossclassified,1,0,1
12292,planter,table,crossclassified,1,0,1
15472,earrings,woman,crossclassified,1,0,1
12295,car,staring,crossclassified,1,1,0
12001,cabinet,lateen,crossclassified,1,1,0
12002,cabinet,washbasin,crossclassified,1,1,0
11564,bunny,table,crossclassified,1,0,1
15148,coco,table,crossclassified,1,0,1
11566,man,recorder,crossclassified,1,1,0
15149,football,girl,crossclassified,1,0,1
12004,ship,wheel,crossclassified,1,1,0
12291,bench,korean,crossclassified,1,1,0
12290,basement,carpet,crossclassified,1,0,1
15425,dugout,grill,crossclassified,1,1,0
15447,figurine,vase,crossclassified,1,0,1
11567,kittenish,man,crossclassified,1,0,1
12288,counter,passionless,crossclassified,1,1,0
15218,couch,errs,crossclassified,1,1,0
12283,counter,person,hypernymy.2,1,1,0
11577,man,visors,crossclassified,1,1,0
15423,cabinet,chili,crossclassified,1,1,0
12013,buffalo,curtain,crossclassified,1,0,1
15262,pot,rug,crossclassified,1,0,1
12273,counter,toaster,crossclassified,1,1,0
12012,bull,curtain,crossclassified,1,0,1
12272,car,stranded,crossclassified,1,1,0
12271,bill,motorcycle,crossclassified,1,0,1
11587,aquarium,display,crossclassified,1,1,0
12270,truck,vase,crossclassified,1,1,0
12014,curtain,partition,crossclassified,1,1,0
15302,attire,robe,crossclassified,1,0,1
12269,table,workspace,crossclassified,1,1,0
12268,train,zebra,crossclassified,1,1,0
15819,batter,pants,crossclassified,1,0,1
11588,aquarium,frame,crossclassified,1,1,0
15263,glove,woman,crossclassified,1,0,1
12016,table,tomato,crossclassified,1,1,0
12267,boat,tub,crossclassified,1,1,0
12274,mans,truck,crossclassified,1,0,1
11766,bridge,sea,crossclassified,1,1,0
12282,desk,jeans,crossclassified,1,1,0
11767,truck,whirl,crossclassified,1,1,0
11578,paper,rug,crossclassified,1,0,1
15216,knife,weapon,hypernymy.2,1,1,0
15471,counter,heater,crossclassified,1,1,0
12281,desk,shins,crossclassified,1,1,0
15150,laundry,shirt,co-hyponymy,1,0,1
11768,sweats,table,crossclassified,1,0,1
11580,cutter,table,crossclassified,1,0,1
12278,train,water,crossclassified,1,1,0
15152,dresses,shirt,crossclassified,1,0,1
15151,luggage,shirt,crossclassified,1,0,1
11582,boy,hotdog,crossclassified,1,1,0
12009,laden,toilet,crossclassified,1,0,1
12010,motorcycle,officers,crossclassified,1,1,0
11583,gran,truck,crossclassified,1,0,1
15398,building,vegetables,crossclassified,1,1,0
11584,house,mask,crossclassified,1,1,0
12328,stand,wall,crossclassified,1,1,0
12993,bowl,carat,crossclassified,1,1,0
12534,colorings,table,crossclassified,1,0,1
14643,couch,present,crossclassified,1,1,0
13815,dog,wrap,crossclassified,1,1,0
13814,dock,shirt,crossclassified,1,1,0
13813,dock,watch,crossclassified,1,1,0
13812,dock,tom,crossclassified,1,1,0
13811,dock,t-shirt,crossclassified,1,1,0
14634,anemone,coral,co-hyponymy,1,0,1
13809,dock,pole,crossclassified,1,1,0
13808,cup,rug,crossclassified,1,0,1
14635,aquarium,coral,crossclassified,1,0,1
15718,shower,sink,co-hyponymy,1,1,0
14636,coral,shell,crossclassified,1,1,0
13807,chair,skateboarder,crossclassified,1,0,1
14637,doll,sofa,crossclassified,1,0,1
13806,controllership,jacket,crossclassified,1,0,1
13805,jacket,remoteness,crossclassified,1,1,0
13804,christmas,girl,crossclassified,1,0,1
13803,girl,panda,crossclassified,1,1,0
14638,barrier,bench,crossclassified,1,0,1
13802,trace,truck,crossclassified,1,0,1
13801,donut,photo,crossclassified,1,1,0
13800,donut,things,crossclassified,1,1,0
14639,bench,cannon,crossclassified,1,1,0
13798,board,bookshelf,crossclassified,1,0,1
14640,girl,hipster,crossclassified,1,1,0
14641,doughnuts,jacket,crossclassified,1,0,1
13796,bookshelf,jug,crossclassified,1,1,0
14642,couch,watch,crossclassified,1,1,0
13795,bookshelf,bottle,crossclassified,1,1,0
13793,cheese,dish,crossclassified,1,1,0
13816,t-shirt,toy,crossclassified,1,0,1
15717,cap,shower,crossclassified,1,0,1
14632,coral,reef,crossclassified,1,1,0
14627,collinear,shirt,crossclassified,1,0,1
13846,cupcakes,dessert,crossclassified,1,1,0
14620,businesswoman,woman,crossclassified,1,0,1
14621,bezant,pizza,crossclassified,1,0,1
13844,cupcakes,pizza,crossclassified,1,1,0
13843,cupcakes,donut,crossclassified,1,1,0
13841,tub,washroom,crossclassified,1,1,0
13840,chair,tub,crossclassified,1,0,1
13839,tub,washstand,crossclassified,1,1,0
14624,cow,hide,crossclassified,1,1,0
13838,cupboard,tub,crossclassified,1,0,1
15614,bear,t-shirt,crossclassified,1,1,0
14626,back,cow,crossclassified,1,0,1
13835,clock,wall,crossclassified,1,1,0
13832,pickle,sandwich,crossclassified,1,0,1
14631,coral,toy,crossclassified,1,1,0
13829,cat,fabric,crossclassified,1,1,0
13828,cat,wall,crossclassified,1,1,0
13827,laotian,table,crossclassified,1,0,1
13826,plat,shirt,crossclassified,1,0,1
15716,cupboard,shower,crossclassified,1,0,1
13825,car,hydrate,crossclassified,1,1,0
14629,coral,water,crossclassified,1,1,0
13823,dress,jumpsuit,crossclassified,1,1,0
13822,brush,cat,crossclassified,1,0,1
13821,cow,wrap,crossclassified,1,1,0
13820,spoon,vase,crossclassified,1,0,1
14630,coral,doll,crossclassified,1,1,0
13818,blouse,toy,crossclassified,1,0,1
13792,cheese,cream,co-hyponymy,1,1,0
13791,cheese,mayo,crossclassified,1,1,0
13848,crackers,cupcakes,crossclassified,1,0,1
14644,car,skateboard,co-hyponymy,1,1,0
15613,person,tire,crossclassified,1,1,0
14650,carpet,snakes,crossclassified,1,1,0
14651,cage,curtain,crossclassified,1,0,1
14654,bridge,jump,crossclassified,1,1,0
13753,gloves,jersey,crossclassified,1,0,1
14656,greens,table,crossclassified,1,0,1
14657,banana,dish,crossclassified,1,1,0
13752,cap,jersey,crossclassified,1,0,1
13751,hood,scorch,crossclassified,1,1,0
13750,hood,sweater,crossclassified,1,1,0
13749,cake,hood,crossclassified,1,0,1
14658,banana,cheese,crossclassified,1,1,0
13748,hair,hood,crossclassified,1,0,1
13746,bun,hood,crossclassified,1,0,1
14660,banana,ham,crossclassified,1,1,0
14662,banana,turkey,crossclassified,1,1,0
13743,counter,jar,crossclassified,1,1,0
14663,banana,bread,crossclassified,1,1,0
13741,cotton,curtain,crossclassified,1,0,1
13740,dugout,stands,crossclassified,1,1,0
13739,cover,dress,crossclassified,1,0,1
13738,dress,sheet,crossclassified,1,1,0
13737,horse,pee,crossclassified,1,1,0
13736,helmet,women,crossclassified,1,1,0
13735,bad,helmet,crossclassified,1,0,1
13734,helmet,pole,crossclassified,1,1,0
13733,napkin,table,crossclassified,1,0,1
13732,dog,mouse,crossclassified,1,1,0
13731,ball,desk,crossclassified,1,0,1
14649,frame,house,crossclassified,1,0,1
13757,benches,wooden,crossclassified,1,1,0
15720,dugout,entrance,crossclassified,1,1,0
13773,cow,wire,crossclassified,1,1,0
15719,glass,shower,crossclassified,1,0,1
13790,cheese,condiments,crossclassified,1,1,0
13788,rug,tomato,crossclassified,1,1,0
13786,bowl,unknown,crossclassified,1,1,0
13784,shack,shelter,hypernymy.2,1,0,1
13783,animal,shelter,crossclassified,1,0,1
13782,covering,shelter,hypernymy.1,1,0,1
13781,sheathing,shelter,co-hyponymy,1,0,1
13780,cover,shelter,co-hyponymy,1,0,1
13777,adolescent,girl,crossclassified,1,0,1
13776,girl,monitor,crossclassified,1,1,0
13775,girl,wire,crossclassified,1,1,0
14645,cowboy,woman,crossclassified,1,0,1
13772,steps,woman,crossclassified,1,0,1
13758,counter,sandal,crossclassified,1,1,0
13771,noodle,rice,crossclassified,1,0,1
13770,camouflage,jacket,crossclassified,1,0,1
14646,horse,leaf,crossclassified,1,1,0
13769,anorak,jacket,hypernymy.2,1,0,1
13768,vase,window,crossclassified,1,1,0
13767,salzburg,zebra,crossclassified,1,0,1
13766,cullender,curtain,crossclassified,1,0,1
14648,house,peon,crossclassified,1,1,0
13764,burger,knife,crossclassified,1,0,1
13763,heart,pizza,crossclassified,1,0,1
13762,cover,pizza,crossclassified,1,0,1
13760,food,spinach,hypernymy.1,1,1,0
13759,bet,counter,crossclassified,1,0,1
13847,cupcakes,frosting,crossclassified,1,1,0
13849,cupcakes,sweet,crossclassified,1,1,0
13729,belt,mask,crossclassified,1,0,1
14594,auk,duck,crossclassified,1,0,1
13927,birdbath,statue,crossclassified,1,1,0
13926,bath,birdbath,crossclassified,1,0,1
14584,building,dock,crossclassified,1,1,0
13925,birdbath,drinker,crossclassified,1,1,0
14585,boat,poet,crossclassified,1,1,0
15711,bike,vehicle,hypernymy.2,1,1,0
13924,birdbath,vase,crossclassified,1,1,0
13923,birdbath,plate,crossclassified,1,1,0
15712,bike,cyclist,crossclassified,1,1,0
13920,cpu,table,crossclassified,1,0,1
14586,bawl,shirt,crossclassified,1,0,1
13919,jumper,man,co-hyponymy,1,0,1
13918,chair,torso,crossclassified,1,1,0
13916,pitcher,vehicles,crossclassified,1,1,0
13915,boat,sky,crossclassified,1,1,0
13914,glass,plate,co-hyponymy,1,1,0
13913,artwork,motorcycle,crossclassified,1,0,1
13912,hotdog,vegetates,crossclassified,1,1,0
13911,hotdog,watermelon,crossclassified,1,1,0
14589,sidewalk,wheel,crossclassified,1,1,0
13910,bat,plane,crossclassified,1,0,1
14590,sidewalk,tyre,crossclassified,1,1,0
14591,sidewalk,train,crossclassified,1,1,0
13909,plane,shoe,crossclassified,1,1,0
14592,roadway,sidewalk,crossclassified,1,0,1
13907,bate,bottle,crossclassified,1,0,1
14593,cake,custard,co-hyponymy,1,1,0
13903,marina,pier,crossclassified,1,1,0
13902,marina,shipyard,crossclassified,1,1,0
14583,building,marina,crossclassified,1,1,0
13928,painter,shirt,crossclassified,1,0,1
13929,bolt,shirt,crossclassified,1,0,1
13942,bridge,tam,crossclassified,1,1,0
14570,sheep,water,crossclassified,1,1,0
13956,bun,sees,crossclassified,1,1,0
13955,bun,plat,crossclassified,1,1,0
14571,berate,bridge,crossclassified,1,0,1
13953,blanket,curtain,crossclassified,1,0,1
13952,boy,goat,crossclassified,1,1,0
13951,store,train,crossclassified,1,0,1
13947,curtain,washbasin,crossclassified,1,1,0
13946,box,curtain,crossclassified,1,0,1
15627,rug,stage,crossclassified,1,1,0
13944,bridge,secondarily,crossclassified,1,1,0
14572,carpet,slipper,crossclassified,1,1,0
13943,bridge,tilt,crossclassified,1,1,0
15626,dresser,woodcarvings,crossclassified,1,1,0
15624,dresser,sofa,crossclassified,1,1,0
13941,cinderella,photo,crossclassified,1,1,0
15625,dresser,window,crossclassified,1,1,0
14574,hair,mobile,crossclassified,1,1,0
15708,bicyclist,bike,crossclassified,1,0,1
14575,hair,kid,crossclassified,1,1,0
14576,hair,screen,crossclassified,1,1,0
14578,shat,shirt,crossclassified,1,0,1
13933,hindoo,house,crossclassified,1,0,1
14579,counter,lap,crossclassified,1,1,0
14580,airplane,bike,crossclassified,1,1,0
14581,tomato,tomatoes,synonymy,1,1,0
13932,dolphin,kite,crossclassified,1,0,1
13931,kite,sea,crossclassified,1,1,0
13901,marina,pole,crossclassified,1,1,0
13899,bay,marina,crossclassified,1,0,1
15616,bear,head,crossclassified,1,1,0
13898,marina,ship,crossclassified,1,1,0
14606,chair,show,crossclassified,1,1,0
15620,bridge,plate,hypernymy.2,1,1,0
13871,juice,tea,crossclassified,1,0,1
14607,rug,tyre,crossclassified,1,1,0
14610,headlight,rug,crossclassified,1,0,1
15618,bench,girlhoods,crossclassified,1,1,0
13869,cat,vehicle,hypernymy.2,1,1,0
13868,cat,mattress,crossclassified,1,1,0
13867,bench,skating,crossclassified,1,1,0
13866,bridge,runoff,crossclassified,1,1,0
13865,bridge,drainage,crossclassified,1,1,0
14611,cycle,rug,crossclassified,1,0,1
13864,dye,man,crossclassified,1,0,1
13863,art,statue,hypernymy.1,1,0,1
14612,remoteness,shirt,crossclassified,1,0,1
13861,desk,luggage,crossclassified,1,1,0
14613,kerchief,shirt,crossclassified,1,0,1
15617,bear,eye,crossclassified,1,1,0
14614,cabinet,light,crossclassified,1,1,0
13856,beard,sweater,co-hyponymy,1,1,0
14617,car,plate,crossclassified,1,1,0
14618,car,pillow,crossclassified,1,1,0
13855,beard,collar,crossclassified,1,1,0
13854,beard,t-shirt,crossclassified,1,1,0
13853,beard,mobile,crossclassified,1,1,0
13852,beard,sunglasses,crossclassified,1,1,0
13851,guy,tent,crossclassified,1,0,1
14619,file,woman,crossclassified,1,0,1
13850,jeans,tent,crossclassified,1,0,1
14605,blender,smoothy,crossclassified,1,1,0
13873,beverage,tea,hypernymy.1,1,0,1
13874,ice,tea,crossclassified,1,0,1
14596,battle,vase,crossclassified,1,0,1
13897,marina,sea,crossclassified,1,1,0
13896,der,shirt,crossclassified,1,0,1
13895,horse,vehicle,crossclassified,1,1,0
13894,tent,truck,crossclassified,1,1,0
13893,belt,tent,crossclassified,1,0,1
13892,tent,wrap,crossclassified,1,1,0
13891,cloth,floor,crossclassified,1,0,1
13890,giraffe,grape,crossclassified,1,1,0
13889,airplane,bench,crossclassified,1,1,0
13888,grate,table,crossclassified,1,0,1
14595,car,pack,crossclassified,1,1,0
15622,bird,meat,hypernymy.2,1,1,0
15713,animal,bike,crossclassified,1,0,1
15621,bed,train,crossclassified,1,1,0
14604,blender,plate,crossclassified,1,1,0
15714,drink,girl,crossclassified,1,0,1
14598,door,vase,crossclassified,1,0,1
14599,curtain,photo,crossclassified,1,1,0
13884,fruits,tent,crossclassified,1,0,1
14600,jet,smog,crossclassified,1,1,0
13883,sunshade,tent,crossclassified,1,0,1
13882,booth,tent,crossclassified,1,0,1
13881,tent,tomato,crossclassified,1,1,0
13880,canape,tent,crossclassified,1,0,1
13878,cake,sticks,crossclassified,1,1,0
14601,jet,setback,crossclassified,1,1,0
14602,giraffe,jet,crossclassified,1,0,1
13875,boy,swimmer,crossclassified,1,1,0
13730,head,mask,crossclassified,1,0,1
15721,cupboard,dugout,crossclassified,1,0,1
13515,boat,girl,crossclassified,1,0,1
13565,sauce,waffle,crossclassified,1,0,1
13590,chaise,sofa,crossclassified,1,0,1
13589,jacket,knee,crossclassified,1,1,0
13588,airplane,belt,crossclassified,1,1,0
13587,airplane,tishri,crossclassified,1,1,0
15731,bench,lampshade,crossclassified,1,1,0
15732,girl,snacks,crossclassified,1,1,0
13586,mirror,moped,crossclassified,1,0,1
14722,bedroom,carpet,crossclassified,1,0,1
14724,show,skater,crossclassified,1,0,1
14725,shirt,vessel,crossclassified,1,1,0
13583,elephant,shirt,crossclassified,1,0,1
13582,animal,stone,crossclassified,1,1,0
13581,cake,paper,crossclassified,1,1,0
14727,awning,pizza,crossclassified,1,1,0
15733,bench,heels,crossclassified,1,1,0
13577,countertop,spoon,crossclassified,1,0,1
15593,bids,couch,crossclassified,1,0,1
14728,awning,trek,crossclassified,1,1,0
15592,car,pored,crossclassified,1,1,0
13574,ship,shirt,crossclassified,1,1,0
13573,counter,shirts,crossclassified,1,1,0
15591,building,soil,crossclassified,1,1,0
13572,counter,wine,crossclassified,1,1,0
13571,coat,duffel,crossclassified,1,1,0
13570,coat,ringmaster,crossclassified,1,1,0
15590,boy,shier,crossclassified,1,1,0
13569,plate,skateboarder,crossclassified,1,0,1
13568,breakfast,waffle,crossclassified,1,0,1
13567,snacks,waffle,crossclassified,1,0,1
13591,armchair,sofa,crossclassified,1,0,1
13592,animal,sofa,crossclassified,1,0,1
13593,car,priest,crossclassified,1,1,0
13606,boat,tomato,crossclassified,1,1,0
14709,clothing,plate,crossclassified,1,0,1
13620,counter,onion,crossclassified,1,1,0
14711,snakes,spoon,crossclassified,1,0,1
14713,portion,spoon,crossclassified,1,0,1
13619,broccoli,counter,crossclassified,1,0,1
14714,amarelle,man,crossclassified,1,0,1
15729,signal,train,crossclassified,1,0,1
13615,bowl,stews,crossclassified,1,1,0
13614,pizza,shooting,crossclassified,1,1,0
13612,storefront,systole,crossclassified,1,1,0
13610,cub,jacket,crossclassified,1,0,1
13609,jacket,rabbit,crossclassified,1,1,0
13608,boat,stall,crossclassified,1,1,0
15596,skier,tress,crossclassified,1,1,0
13594,car,pastor,crossclassified,1,1,0
13605,interior,window,crossclassified,1,0,1
15595,rug,things,crossclassified,1,1,0
15730,bench,boards,crossclassified,1,1,0
14716,dessert,fork,crossclassified,1,0,1
14717,bridge,sedan,crossclassified,1,1,0
14718,counter,ire,crossclassified,1,1,0
13602,suite,window,crossclassified,1,0,1
14719,chisellers,counter,crossclassified,1,0,1
14720,beat,carpet,crossclassified,1,0,1
13600,bird,stem,crossclassified,1,1,0
14721,carpet,giraffe,crossclassified,1,1,0
13597,child,sink,crossclassified,1,1,0
13595,book,car,crossclassified,1,0,1
15589,bench,tress,crossclassified,1,1,0
13564,cup,daddy,crossclassified,1,1,0
15597,badged,bed,crossclassified,1,0,1
14729,awning,car,crossclassified,1,1,0
14744,truck,vena,crossclassified,1,1,0
13537,elephant,screen,crossclassified,1,1,0
14745,pizza,player,crossclassified,1,0,1
13535,cake,container,crossclassified,1,1,0
14746,bench,sue,crossclassified,1,1,0
13534,coolers,shirt,crossclassified,1,0,1
13533,beach,house,crossclassified,1,0,1
13532,horse,mask,crossclassified,1,1,0
13531,bagel,snakes,crossclassified,1,1,0
15586,desk,fort,crossclassified,1,1,0
13530,bed,feet,hypernymy.2,1,1,0
14747,flamingo,swam,crossclassified,1,1,0
13528,goat,tie,crossclassified,1,0,1
14748,food,fry,crossclassified,1,1,0
15737,horse,horsetail,crossclassified,1,1,0
14749,food,meatballs,hypernymy.1,1,1,0
14750,food,plat,crossclassified,1,1,0
15738,fry,grill,crossclassified,1,0,1
13526,bathtub,plywood,crossclassified,1,1,0
14751,man,moselle,crossclassified,1,1,0
13524,bed,slacks,crossclassified,1,1,0
13523,dog,mammal,hypernymy.2,1,1,0
13522,mover,train,crossclassified,1,0,1
15585,boat,boot,crossclassified,1,1,0
13521,train,warehouse,crossclassified,1,1,0
13520,bed,playing,crossclassified,1,1,0
13519,surfer,waterman,crossclassified,1,1,0
13518,sauce,shirt,crossclassified,1,0,1
15584,tempo,truck,crossclassified,1,0,1
14743,building,lap,crossclassified,1,1,0
14742,dog,huskies,hypernymy.1,1,1,0
15736,buttocks,horse,crossclassified,1,0,1
13552,blackshirt,motorcycle,crossclassified,1,0,1
14730,awning,buses,crossclassified,1,1,0
13562,bed,heart,crossclassified,1,1,0
13561,bonnet,hood,synonymy,1,0,1
13560,hat,skier,crossclassified,1,0,1
13559,skateboarder,sneaker,crossclassified,1,1,0
13557,kite,leaf,crossclassified,1,1,0
14732,awning,kiosk,crossclassified,1,1,0
14733,awning,pole,crossclassified,1,1,0
14734,awning,terminal,crossclassified,1,1,0
13555,heron,kite,crossclassified,1,0,1
15588,catcher,hazmat,crossclassified,1,1,0
14736,awning,tolkien,crossclassified,1,1,0
13553,cloth,kite,crossclassified,1,0,1
13551,bottle,jug,hypernymy.1,1,1,0
14741,dog,wolf,co-hyponymy,1,1,0
13550,sweater,twister,crossclassified,1,1,0
14737,awning,lanes,crossclassified,1,1,0
13548,bench,ship,crossclassified,1,1,0
14738,awning,stop,crossclassified,1,1,0
13547,bench,pool,crossclassified,1,1,0
14739,decoration,flower,crossclassified,1,0,1
15734,fry,tent,crossclassified,1,0,1
13546,pant,player,crossclassified,1,0,1
14740,carpet,train,crossclassified,1,1,0
13545,cake,statuary,crossclassified,1,1,0
13544,cake,strawberry,crossclassified,1,1,0
13543,cake,cherry,crossclassified,1,1,0
15735,stall,tent,crossclassified,1,0,1
14708,market,table,crossclassified,1,0,1
14707,bathtub,cubs,crossclassified,1,1,0
13726,parrot,peak,crossclassified,1,1,0
13677,bridge,player,crossclassified,1,1,0
13700,bench,skateboarder,crossclassified,1,1,0
13699,carat,girl,crossclassified,1,0,1
13697,mat,train,crossclassified,1,0,1
14679,fortes,fruit,crossclassified,1,0,1
14680,fruit,mango,hypernymy.1,1,1,0
13696,knife,t-shirt,crossclassified,1,1,0
13695,boy,cover,crossclassified,1,1,0
13694,fresh,man,crossclassified,1,0,1
14681,guy,player,crossclassified,1,0,1
13693,man,painful,crossclassified,1,1,0
14682,blinds,jacket,crossclassified,1,0,1
15611,garb,person,crossclassified,1,0,1
14683,stove,woman,crossclassified,1,0,1
13690,nuts,plate,crossclassified,1,0,1
15610,person,robe,crossclassified,1,1,0
13689,couch,lady,crossclassified,1,1,0
14684,fry,sandwich,crossclassified,1,0,1
13688,airplane,house,crossclassified,1,0,1
13687,buffet,desk,crossclassified,1,0,1
15724,moan,woman,crossclassified,1,0,1
13686,classes,desk,crossclassified,1,0,1
14686,newspaperman,woman,crossclassified,1,0,1
14687,car,limo,hypernymy.1,1,1,0
13685,desk,kiosk,crossclassified,1,1,0
13684,nameplate,plane,crossclassified,1,0,1
13683,plane,wotan,crossclassified,1,1,0
13682,bridge,meir,crossclassified,1,1,0
13681,closet,curtain,crossclassified,1,0,1
13679,cloves,snowboarder,crossclassified,1,0,1
14678,jacket,straitjacket,crossclassified,1,1,0
13702,belt,counter,crossclassified,1,0,1
14677,cosmetics,woman,crossclassified,1,0,1
14672,drunk,sweater,crossclassified,1,0,1
13725,cat,lateen,crossclassified,1,1,0
13723,woman,wrap,crossclassified,1,1,0
14666,carpet,lap,crossclassified,1,1,0
13722,boat,kite,crossclassified,1,1,0
15722,bowl,crocodile,crossclassified,1,1,0
14667,baseball,glove,co-hyponymy,1,0,1
13721,pot,stockpot,hypernymy.1,1,1,0
14668,bowl,milk,crossclassified,1,1,0
14669,bowl,butter,crossclassified,1,1,0
13720,marinara,sauce,hypernymy.2,1,0,1
15612,person,vehicle,crossclassified,1,1,0
13718,arms,suit,crossclassified,1,0,1
14670,bowl,tea,crossclassified,1,1,0
15723,carpet,horse,crossclassified,1,1,0
13705,banana,t-shirt,crossclassified,1,1,0
13716,knife,suit,crossclassified,1,0,1
13715,child,toothpastes,crossclassified,1,1,0
14673,lady,sweater,crossclassified,1,0,1
14674,fountain,tent,crossclassified,1,0,1
13714,blender,vase,crossclassified,1,1,0
14675,shirt,sweatband,crossclassified,1,1,0
13712,boat,crane,crossclassified,1,1,0
13711,bun,spinach,crossclassified,1,1,0
13710,cellphone,rug,crossclassified,1,0,1
13709,rug,speaker,crossclassified,1,1,0
13708,banana,turtleneck,crossclassified,1,1,0
13707,banana,eyeballs,crossclassified,1,1,0
14676,class,train,crossclassified,1,0,1
13678,bridge,guy,crossclassified,1,1,0
13674,pegs,shirt,crossclassified,1,0,1
13622,shirt,stroller,crossclassified,1,0,1
13673,house,indoor,crossclassified,1,1,0
13644,animal,turkey,hypernymy.1,1,0,1
13643,tortilla,wrap,crossclassified,1,1,0
13642,side,tortilla,crossclassified,1,0,1
14698,boat,so,crossclassified,1,1,0
15602,tub,wall,crossclassified,1,1,0
14699,boat,sign,crossclassified,1,1,0
15601,carpet,piano,crossclassified,1,1,0
13639,cake,tortilla,hypernymy.1,1,0,1
14700,boat,signpost,crossclassified,1,1,0
14701,horse,muzzle,crossclassified,1,1,0
13637,couch,pole,crossclassified,1,1,0
13636,garment,shirt,hypernymy.1,1,0,1
14702,blinder,horse,crossclassified,1,0,1
13635,bread,cutis,crossclassified,1,1,0
13634,children,rug,crossclassified,1,0,1
14703,all,bed,crossclassified,1,0,1
15600,bathtub,towel,crossclassified,1,1,0
13631,cabinet,micheas,crossclassified,1,1,0
15599,boat,hydrofoil,hypernymy.1,1,1,0
13630,cabinet,mixer,crossclassified,1,1,0
13629,bird,knife,crossclassified,1,0,1
13628,knife,shooting,crossclassified,1,1,0
13627,cheep,cow,crossclassified,1,0,1
15598,animal,flamingo,hypernymy.1,1,0,1
14705,cow,wool,crossclassified,1,1,0
13626,cow,stone,crossclassified,1,1,0
13625,bread,spoon,crossclassified,1,0,1
13624,onion,spoon,crossclassified,1,0,1
13623,roller,stroller,crossclassified,1,0,1
13645,ostrich,turkey,crossclassified,1,0,1
14697,samara,woman,crossclassified,1,0,1
15728,cage,train,crossclassified,1,0,1
15603,boy,scissors,crossclassified,1,1,0
15726,beach,wheel,crossclassified,1,1,0
13672,attic,house,crossclassified,1,0,1
14690,nightshirt,shirt,crossclassified,1,0,1
13671,house,screen,crossclassified,1,1,0
13670,giraffe,rope,crossclassified,1,1,0
14691,apple,shirt,crossclassified,1,0,1
13668,chocolate,meat,co-hyponymy,1,0,1
15608,t-shirt,vase,crossclassified,1,0,1
14693,flower,phone,crossclassified,1,1,0
15607,businesswoman,man,crossclassified,1,0,1
15606,child,train,crossclassified,1,1,0
13667,barbecue,meat,crossclassified,1,0,1
15605,child,vamp,crossclassified,1,1,0
13664,gravy,meat,crossclassified,1,0,1
13646,crane,turkey,crossclassified,1,0,1
14694,headset,woman,crossclassified,1,0,1
14695,coat,face,crossclassified,1,1,0
13662,cloth,house,crossclassified,1,0,1
13661,bridge,turk,crossclassified,1,1,0
14696,desk,mike,crossclassified,1,1,0
13660,luggage,table,crossclassified,1,0,1
13659,doll,floor,crossclassified,1,0,1
13658,floor,shelf,crossclassified,1,1,0
13655,tracks,walkway,crossclassified,1,1,0
15727,airplane,beach,crossclassified,1,0,1
13650,dinner,pot,crossclassified,1,0,1
13648,pot,tomato,crossclassified,1,1,0
13647,geese,turkey,co-hyponymy,1,0,1
13958,remoteness,rug,crossclassified,1,0,1
14569,bathtub,electronics,crossclassified,1,1,0
14568,bathtub,pot,co-hyponymy,1,1,0
14211,bridge,rake,crossclassified,1,1,0
14434,chairs,tent,crossclassified,1,0,1
14240,dresses,jacket,crossclassified,1,0,1
14239,jacket,traveler,crossclassified,1,1,0
14238,fabric,jacket,crossclassified,1,0,1
14236,buzzard,pizza,crossclassified,1,0,1
14235,car,license,crossclassified,1,1,0
14233,child,sunglass,crossclassified,1,1,0
14435,carpet,tent,crossclassified,1,0,1
14232,baby,bench,crossclassified,1,0,1
15675,child,rope,crossclassified,1,1,0
14230,ball,bench,crossclassified,1,0,1
14436,cantle,table,crossclassified,1,0,1
14437,sandwich,tacos,crossclassified,1,1,0
14229,bad,jacket,crossclassified,1,0,1
14438,rolls,sandwich,crossclassified,1,0,1
14227,building,cap,crossclassified,1,1,0
14440,blinds,lamp,crossclassified,1,0,1
14224,blazer,car,crossclassified,1,0,1
14223,man,ranger,hypernymy.1,1,1,0
14441,cat,teeth,crossclassified,1,1,0
14221,snowboarder,women,crossclassified,1,1,0
14220,dog,faces,crossclassified,1,1,0
14219,dog,friends,crossclassified,1,1,0
14218,sand,sandwich,crossclassified,1,0,1
14217,rake,truck,crossclassified,1,0,1
14216,car,mouse,crossclassified,1,0,1
14215,mouse,punch,crossclassified,1,1,0
15643,catcher,kid,crossclassified,1,1,0
14214,mouse,shadow,crossclassified,1,1,0
14242,lowercase,vase,crossclassified,1,0,1
14243,tie,vase,crossclassified,1,0,1
14433,tent,walls,crossclassified,1,1,0
14422,drains,man,crossclassified,1,0,1
14416,paperwork,table,crossclassified,1,0,1
14261,dresser,picture,crossclassified,1,0,1
14260,furniture,picture,crossclassified,1,0,1
14417,conveyance,truck,hypernymy.1,1,0,1
15671,fruits,girl,crossclassified,1,0,1
15672,desktop,keyboard,crossclassified,1,0,1
14259,cupboard,picture,crossclassified,1,0,1
14258,picture,shelf,crossclassified,1,1,0
14419,meat,snakes,crossclassified,1,1,0
14256,clock,picture,crossclassified,1,0,1
14255,decoration,picture,crossclassified,1,0,1
14420,meat,snacks,crossclassified,1,1,0
14421,bench,fur,crossclassified,1,1,0
15673,electronics,keyboard,crossclassified,1,0,1
14432,flags,tent,crossclassified,1,0,1
14251,bench,truck,crossclassified,1,0,1
14425,signage,truck,crossclassified,1,0,1
14426,handkerchief,sink,crossclassified,1,0,1
14250,glider,sail,crossclassified,1,0,1
14247,sail,surfboard,crossclassified,1,1,0
14246,sail,shirt,crossclassified,1,1,0
14245,fruitlessness,spoon,crossclassified,1,0,1
14428,asian,rice,crossclassified,1,0,1
14429,lipstick,shirt,crossclassified,1,0,1
14244,ice,spoon,crossclassified,1,0,1
14430,dog,mutt,hypernymy.1,1,1,0
15674,road,sheep,crossclassified,1,0,1
14431,decorations,tent,crossclassified,1,0,1
14212,car,chef,crossclassified,1,1,0
14210,board,jacket,crossclassified,1,0,1
14264,boy,shortstop,crossclassified,1,1,0
14209,cat,tv,crossclassified,1,1,0
14186,bird,surfer,crossclassified,1,1,0
14184,boat,tree,crossclassified,1,1,0
14456,shirt,sweatbands,crossclassified,1,1,0
14183,eggs,sandwich,crossclassified,1,0,1
14182,cap,tie,crossclassified,1,0,1
14181,gun,tie,crossclassified,1,0,1
14180,jacket,mom,crossclassified,1,1,0
14179,jacket,specs,crossclassified,1,1,0
14458,man,sitter,crossclassified,1,1,0
15682,shear,woman,crossclassified,1,0,1
14178,hug,jacket,crossclassified,1,0,1
14177,flag,vase,crossclassified,1,0,1
14176,jacket,vase,crossclassified,1,0,1
14175,griddle,pan,co-hyponymy,1,0,1
15641,motorcycle,patio,crossclassified,1,1,0
14461,shitwork,woman,crossclassified,1,0,1
14462,puppy,woman,crossclassified,1,0,1
14464,clothes,couch,crossclassified,1,0,1
14172,cauliflower,girl,crossclassified,1,0,1
14169,girl,ribbon,crossclassified,1,1,0
15683,sundress,woman,crossclassified,1,0,1
15684,boat,bout,crossclassified,1,1,0
15685,bed,pen,crossclassified,1,1,0
14164,bowl,jar,co-hyponymy,1,1,0
14163,couch,kitten,crossclassified,1,1,0
14467,bird,tail,crossclassified,1,1,0
14162,couch,pillows,crossclassified,1,1,0
14161,skier,sticks,crossclassified,1,1,0
14160,bus,jacket,crossclassified,1,0,1
14455,seats,shirt,crossclassified,1,0,1
14189,hat,salad,crossclassified,1,1,0
14190,box,mouse,crossclassified,1,0,1
14447,bathrooms,counter,crossclassified,1,0,1
14207,shirt,shirts,synonymy,1,1,0
14442,cat,picture,crossclassified,1,1,0
14443,tirade,truck,crossclassified,1,0,1
15642,motorcycle,torso,crossclassified,1,1,0
14204,gate,train,crossclassified,1,0,1
14203,gave,table,crossclassified,1,0,1
15678,spectators,tent,crossclassified,1,0,1
14202,bared,sandwich,crossclassified,1,0,1
14201,food,vegetal,crossclassified,1,1,0
14445,curtain,netting,crossclassified,1,1,0
15679,cafe,desk,crossclassified,1,0,1
14199,dress,remoteness,crossclassified,1,1,0
14446,curtain,net,crossclassified,1,1,0
14198,dress,tree,crossclassified,1,1,0
14191,mouse,tub,crossclassified,1,1,0
14448,banana,salad,crossclassified,1,0,1
14197,shirting,woman,crossclassified,1,0,1
14196,pizza,truck,crossclassified,1,0,1
15680,ampullae,train,crossclassified,1,0,1
14195,pizzeria,truck,crossclassified,1,0,1
14449,fork,muffin,crossclassified,1,1,0
14194,building,tale,crossclassified,1,1,0
15681,phoneme,woman,crossclassified,1,0,1
14450,fry,jacket,crossclassified,1,0,1
14451,jacket,steel,crossclassified,1,1,0
14193,clock,glass,crossclassified,1,1,0
14452,desk,printer,crossclassified,1,1,0
14453,knife,vegetable,crossclassified,1,1,0
14263,bowl,moirai,crossclassified,1,1,0
15645,bookshelf,capote,crossclassified,1,1,0
14567,couch,tag,crossclassified,1,1,0
14303,bookshelf,curtain,crossclassified,1,1,0
15664,bay,man,crossclassified,1,0,1
14326,clothes,gown,crossclassified,1,0,1
14366,plane,underbelly,crossclassified,1,1,0
14367,bucket,olives,crossclassified,1,1,0
15665,baby,giraffe,crossclassified,1,0,1
14368,bucket,spurt,crossclassified,1,1,0
14322,bellow,sofa,crossclassified,1,0,1
14369,child,mixer,crossclassified,1,1,0
14320,man,panda,crossclassified,1,1,0
15666,confused,woman,crossclassified,1,0,1
14319,apple,toaster,crossclassified,1,0,1
14318,machine,toaster,crossclassified,1,0,1
14317,container,toaster,crossclassified,1,0,1
15667,plate,spatula,crossclassified,1,0,1
14316,appliance,toaster,hypernymy.1,1,0,1
14374,floor,path,crossclassified,1,1,0
15655,board,vase,crossclassified,1,0,1
14375,mole,shirt,crossclassified,1,0,1
14311,tea,toaster,crossclassified,1,0,1
14376,zebra,zebrass,synonymy,1,1,0
14309,bowl,toaster,crossclassified,1,0,1
14377,bricks,floor,crossclassified,1,1,0
15668,flipper,spatula,crossclassified,1,0,1
14378,bricks,pavement,crossclassified,1,1,0
14307,baby,bookshelf,crossclassified,1,0,1
14379,bricks,concrete,co-hyponymy,1,1,0
14306,bookshelf,chair,crossclassified,1,1,0
14305,bookshelf,toddler,crossclassified,1,1,0
11338,barrels,train,crossclassified,1,0,1
14327,gown,student,crossclassified,1,1,0
14365,craft,plane,hypernymy.1,1,0,1
14364,bottle,buffet,crossclassified,1,0,1
15661,cart,grill,crossclassified,1,0,1
14350,helpmate,jacket,crossclassified,1,0,1
14349,bode,curtain,crossclassified,1,0,1
14351,jacket,whelmed,crossclassified,1,1,0
14348,man,thread,crossclassified,1,1,0
14347,jar,sangria,crossclassified,1,1,0
15660,horse,kid,crossclassified,1,1,0
14352,airplane,fight,crossclassified,1,1,0
15657,potty,vase,crossclassified,1,0,1
14344,jar,jug,co-hyponymy,1,1,0
14342,desk,scope,crossclassified,1,1,0
14341,horse,show,crossclassified,1,1,0
14353,airplane,chicken,crossclassified,1,1,0
14340,umpire,woman,crossclassified,1,0,1
14354,barge,bridge,crossclassified,1,0,1
14363,buffet,countertop,crossclassified,1,1,0
15656,pillar,vase,crossclassified,1,0,1
14355,brat,hotdog,crossclassified,1,0,1
14337,magazine,table,crossclassified,1,0,1
14356,counter,stage,crossclassified,1,1,0
15663,container,grill,crossclassified,1,0,1
14336,donut,hole,crossclassified,1,1,0
14335,auto,building,crossclassified,1,0,1
14359,building,pales,crossclassified,1,1,0
14334,couch,lights,crossclassified,1,1,0
14331,coats,table,crossclassified,1,0,1
14330,hair,table,crossclassified,1,0,1
14329,bus,tyre,crossclassified,1,1,0
14328,couch,trousers,crossclassified,1,1,0
14304,bookshelf,luggage,crossclassified,1,1,0
14380,bricks,wheel,crossclassified,1,1,0
14414,bowl,pole,crossclassified,1,1,0
14300,shirty,tie,crossclassified,1,0,1
14395,soup,stick,crossclassified,1,1,0
14396,cook,soup,crossclassified,1,0,1
14397,fork,soup,crossclassified,1,0,1
14398,soup,wooden,crossclassified,1,1,0
14399,cooking,soup,crossclassified,1,0,1
14400,bird,cloves,crossclassified,1,1,0
15651,horn,truck,crossclassified,1,0,1
15669,supervisor,woman,crossclassified,1,0,1
14272,burrito,man,crossclassified,1,0,1
14271,plane,platform,crossclassified,1,1,0
14402,blew,oatmeal,crossclassified,1,0,1
15650,class,desk,crossclassified,1,0,1
14270,iron,plane,crossclassified,1,0,1
14404,oatmeal,snakes,crossclassified,1,1,0
14405,banana,oatmeal,crossclassified,1,0,1
15649,bench,crotch,crossclassified,1,1,0
15648,knife,spreader,crossclassified,1,1,0
14406,granny,woman,hypernymy.2,1,0,1
14269,eel,motorcycle,crossclassified,1,0,1
14267,bird,snow,crossclassified,1,1,0
14266,bird,eight,crossclassified,1,1,0
14407,bed,wheel,crossclassified,1,1,0
14408,gloves,shirt,crossclassified,1,0,1
14409,platform,woman,crossclassified,1,0,1
14410,building,entranceway,crossclassified,1,1,0
14411,bored,building,crossclassified,1,0,1
15670,bench,rope,crossclassified,1,1,0
15646,chocolate,knife,crossclassified,1,0,1
14265,mice,woman,crossclassified,1,0,1
14394,jug,person,crossclassified,1,0,1
14279,grasses,sidewalk,crossclassified,1,0,1
14393,flask,person,crossclassified,1,0,1
14290,brick,house,crossclassified,1,0,1
14299,man,youth,crossclassified,1,1,0
14298,bed,sweater,crossclassified,1,1,0
14383,desk,letters,crossclassified,1,1,0
15654,scoreboard,skateboarder,crossclassified,1,0,1
14297,dinner,meat,crossclassified,1,0,1
14295,bench,hart,crossclassified,1,1,0
15653,carpet,electronics,crossclassified,1,1,0
14294,footling,hotdog,crossclassified,1,0,1
15652,pipe,truck,crossclassified,1,0,1
14385,bulgur,salad,crossclassified,1,0,1
14293,powerlessness,woman,crossclassified,1,0,1
14291,driver,shirt,crossclassified,1,0,1
14387,braze,bridge,crossclassified,1,0,1
14388,bridge,clock,crossclassified,1,1,0
14280,soil,zebra,crossclassified,1,0,1
14289,chair,mattress,crossclassified,1,1,0
14288,blazer,chair,crossclassified,1,0,1
14287,cow,hoof,crossclassified,1,1,0
14389,corp,shirt,crossclassified,1,0,1
14286,cow,wall,crossclassified,1,1,0
14285,khakis,woman,crossclassified,1,0,1
14390,dowel,woman,crossclassified,1,0,1
14284,tent,tinner,crossclassified,1,1,0
14283,plat,tent,crossclassified,1,0,1
14391,bans,woman,crossclassified,1,0,1
14282,balloon,man,crossclassified,1,0,1
14392,bored,curtain,crossclassified,1,0,1
14281,clay,zebra,crossclassified,1,0,1
14469,boy,pots,crossclassified,1,1,0
15686,car,doll,crossclassified,1,1,0
14159,jacket,street,crossclassified,1,1,0
14018,ruler,stationery,crossclassified,1,1,0
14537,dress,nightshirt,crossclassified,1,1,0
14040,bridge,hut,crossclassified,1,0,1
15634,boy,snacks,crossclassified,1,1,0
15633,bench,walkingstick,crossclassified,1,1,0
14039,foliage,hut,crossclassified,1,0,1
14038,skipping,truck,crossclassified,1,0,1
14538,bake,boy,crossclassified,1,0,1
14037,carpet,things,crossclassified,1,1,0
15632,baseball,bench,crossclassified,1,0,1
14036,motorcycle,wooden,crossclassified,1,1,0
14035,outerwear,skier,crossclassified,1,0,1
14034,custard,food,hypernymy.2,1,0,1
14033,nose,penguin,crossclassified,1,0,1
15701,board,couch,crossclassified,1,0,1
14032,penguin,wing,crossclassified,1,1,0
14539,couch,soup,crossclassified,1,1,0
14030,ball,kettle,crossclassified,1,0,1
14029,cake,kettle,crossclassified,1,0,1
14028,bread,kettle,crossclassified,1,0,1
14027,kettle,percolator,crossclassified,1,1,0
14026,cheese,kettle,crossclassified,1,0,1
14025,bun,kettle,crossclassified,1,0,1
14541,cot,floor,crossclassified,1,0,1
14024,jar,kettle,co-hyponymy,1,0,1
14023,entree,pizza,crossclassified,1,0,1
14022,man,waiter,co-hyponymy,1,1,0
14021,muslim,woman,crossclassified,1,0,1
14020,pen,ruler,crossclassified,1,0,1
15630,saucer,vase,crossclassified,1,0,1
14536,ambulance,vehicle,hypernymy.2,1,1,0
14535,ambulance,wheel,crossclassified,1,1,0
14043,hut,man,crossclassified,1,1,0
14524,children,truck,crossclassified,1,0,1
14518,building,sheep,crossclassified,1,1,0
14519,building,pasture,crossclassified,1,1,0
14055,pizza,souffle,co-hyponymy,1,1,0
15638,populated,tent,crossclassified,1,0,1
15637,camera,tent,crossclassified,1,0,1
14053,ramekin,sauce,crossclassified,1,0,1
15698,car,telephoto,crossclassified,1,1,0
14520,building,stonework,crossclassified,1,1,0
14521,building,goat,crossclassified,1,1,0
14052,liquid,sauce,crossclassified,1,0,1
14522,pizza,store,crossclassified,1,1,0
15636,mobile,tent,crossclassified,1,0,1
14523,corn,knife,crossclassified,1,0,1
14050,jacket,underclothing,crossclassified,1,1,0
14044,ball,hut,crossclassified,1,0,1
14525,girls,truck,crossclassified,1,0,1
14049,desktop,mouse,crossclassified,1,0,1
15699,driver,woman,crossclassified,1,0,1
14528,glass,mobile,crossclassified,1,1,0
14529,glass,mobilization,crossclassified,1,1,0
14531,glass,screen,crossclassified,1,1,0
14047,mouse,remote,crossclassified,1,1,0
14046,knife,tissue,crossclassified,1,1,0
14045,cap,hut,crossclassified,1,0,1
14532,boy,washbasin,crossclassified,1,1,0
15700,bridge,way,crossclassified,1,1,0
15635,torch,woman,crossclassified,1,0,1
14533,basin,boy,crossclassified,1,0,1
14543,glass,rug,crossclassified,1,0,1
14544,sitting,woman,crossclassified,1,0,1
15687,eyeglasses,table,crossclassified,1,0,1
14014,surfer,swimming,crossclassified,1,1,0
13985,hillside,sheep,crossclassified,1,0,1
14557,couch,food,crossclassified,1,1,0
14558,cat,drawing,crossclassified,1,1,0
13984,ground,sheep,crossclassified,1,0,1
13983,prairie,sheep,crossclassified,1,0,1
13982,building,deli,crossclassified,1,1,0
13981,building,courtyard,crossclassified,1,1,0
14559,cat,danger,crossclassified,1,1,0
13978,cap,carriage,crossclassified,1,0,1
13977,carriage,vehicle,hypernymy.2,1,1,0
15704,ottoman,pillow,crossclassified,1,1,0
13975,batter,women,crossclassified,1,1,0
13974,batsman,batter,synonymy,1,0,1
13973,horse,horsepower,crossclassified,1,1,0
13972,bust,jacket,crossclassified,1,0,1
15705,cat,ottoman,crossclassified,1,0,1
14561,boat,ships,co-hyponymy,1,1,0
15706,ottoman,poof,crossclassified,1,1,0
13969,dresser,keyboard,crossclassified,1,1,0
13968,dresser,monitor,crossclassified,1,1,0
14562,cybele,woman,crossclassified,1,0,1
13965,bag,blanket,crossclassified,1,0,1
14563,metals,vase,crossclassified,1,0,1
13963,blanket,keyboard,crossclassified,1,1,0
13962,blanket,book,crossclassified,1,1,0
13961,blanket,laptop,crossclassified,1,1,0
13960,building,hindoo,crossclassified,1,1,0
14566,flowers,shirt,crossclassified,1,0,1
13959,bird,snipe,hypernymy.1,1,1,0
13986,hill,sheep,crossclassified,1,0,1
13988,jacket,peak,crossclassified,1,1,0
13989,closet,toilet,hypernymy.2,1,0,1
14005,hie,surfer,crossclassified,1,0,1
14013,animal,plane,crossclassified,1,0,1
14546,barefoot,man,crossclassified,1,0,1
14012,cat,skateboarder,crossclassified,1,0,1
14547,passenger,train,crossclassified,1,0,1
14548,truck,vendor,crossclassified,1,1,0
14549,cross,dress,crossclassified,1,0,1
14011,boy,football,crossclassified,1,1,0
14551,share,woman,crossclassified,1,0,1
14009,body,suit,crossclassified,1,0,1
14008,bed,carrot,crossclassified,1,1,0
14007,bed,lady,crossclassified,1,1,0
15629,food,vase,crossclassified,1,0,1
14006,giraffe,jacket,crossclassified,1,1,0
14004,surface,surfer,crossclassified,1,0,1
15703,motorcycle,railing,crossclassified,1,1,0
14003,quadruped,zebra,crossclassified,1,0,1
14553,cup,dish,co-hyponymy,1,1,0
14001,blender,lid,crossclassified,1,1,0
14000,sneakers,suit,crossclassified,1,0,1
13999,cake,fruitcake,hypernymy.1,1,1,0
13998,calk,table,crossclassified,1,0,1
13994,footrest,table,crossclassified,1,0,1
13993,seat,table,co-hyponymy,1,0,1
13991,beach,jacket,crossclassified,1,0,1
14555,cup,tin,co-hyponymy,1,1,0
15702,backpack,motorcycle,crossclassified,1,0,1
13990,cigarette,woman,crossclassified,1,0,1
14556,bread,layer,crossclassified,1,1,0
14056,weirdo,woman,crossclassified,1,0,1
15697,car,technology,crossclassified,1,1,0
14057,bridge,tiles,crossclassified,1,1,0
14058,bridge,tire,crossclassified,1,1,0
14136,eagle,owl,co-hyponymy,1,0,1
14135,bed,bowl,crossclassified,1,1,0
14481,doll,vase,crossclassified,1,0,1
14134,containers,food,crossclassified,1,0,1
15692,fry,knife,crossclassified,1,0,1
14132,shirt,toothbrushes,crossclassified,1,1,0
14131,cater,man,crossclassified,1,0,1
14130,dog,male,hypernymy.2,1,1,0
14482,fruit,pizza,crossclassified,1,0,1
14129,fence,hat,crossclassified,1,0,1
14128,bowl,brute,crossclassified,1,1,0
14127,couch,curtains,crossclassified,1,1,0
14483,net,pizza,crossclassified,1,0,1
14126,hat,t-shirt,crossclassified,1,1,0
14124,couch,handbag,crossclassified,1,1,0
14123,airplane,aniline,crossclassified,1,1,0
14484,foil,pizza,crossclassified,1,0,1
14485,pizza,surface,crossclassified,1,1,0
14486,pizza,placeman,crossclassified,1,1,0
14487,pizza,tablecloth,crossclassified,1,1,0
14488,sharia,shirt,crossclassified,1,0,1
15693,board,knife,crossclassified,1,0,1
14122,cabin,counter,crossclassified,1,0,1
14121,drapes,shower,crossclassified,1,0,1
14120,doorway,shower,crossclassified,1,0,1
14489,cay,floor,crossclassified,1,0,1
14490,horse,hotdog,crossclassified,1,0,1
14117,cigarettes,suit,crossclassified,1,0,1
14116,smoke,suit,crossclassified,1,0,1
14480,bean,sink,crossclassified,1,0,1
14138,owl,television,crossclassified,1,1,0
14139,barn,outhouse,crossclassified,1,0,1
14150,cite,salad,crossclassified,1,0,1
14158,jacket,road,crossclassified,1,1,0
14470,boy,trousers,crossclassified,1,1,0
14471,chocolate,table,crossclassified,1,0,1
15688,amarelle,woman,crossclassified,1,0,1
14154,jacket,sign,crossclassified,1,1,0
15640,motorcycle,walkway,crossclassified,1,1,0
14153,man,teeth,crossclassified,1,1,0
14473,motorbike,sidecar,crossclassified,1,0,1
15690,hart,man,crossclassified,1,0,1
14152,flask,man,crossclassified,1,0,1
14474,sidecar,trailer,co-hyponymy,1,1,0
14475,sidecar,timbuktu,crossclassified,1,1,0
14151,man,microwave,crossclassified,1,1,0
14149,dank,horse,crossclassified,1,0,1
14140,outhouse,shack,crossclassified,1,1,0
14477,sink,tape,crossclassified,1,1,0
14148,counter,fryer,crossclassified,1,1,0
14478,container,sink,hypernymy.1,1,0,1
14147,coat,mitten,crossclassified,1,1,0
14146,coat,glove,crossclassified,1,1,0
15639,table,women,crossclassified,1,1,0
14145,bowl,rolls,synonymy,1,1,0
14144,appliance,counter,crossclassified,1,0,1
14479,bath,sink,crossclassified,1,0,1
14143,shirt,vase,crossclassified,1,1,0
14142,door,outhouse,crossclassified,1,0,1
15691,knife,potato,crossclassified,1,1,0
14141,cabin,outhouse,crossclassified,1,0,1
14491,croissant,hotdog,crossclassified,1,0,1
14492,suit,tree,crossclassified,1,1,0
14493,hill,suit,crossclassified,1,0,1
14071,bench,stump,crossclassified,1,0,1
14506,bench,curb,crossclassified,1,1,0
14507,bench,kitten,crossclassified,1,1,0
14508,girl,stria,crossclassified,1,1,0
14081,bowl,frisbee,crossclassified,1,0,1
14509,girl,student,crossclassified,1,1,0
14078,baby,motorcycle,crossclassified,1,0,1
14510,bowl,nutshells,crossclassified,1,1,0
14511,card,jacket,crossclassified,1,0,1
14076,cake,ice,crossclassified,1,1,0
14075,foliage,stump,crossclassified,1,0,1
14074,cup,stump,crossclassified,1,0,1
14073,burrow,stump,crossclassified,1,0,1
14072,hole,stump,crossclassified,1,0,1
14070,planter,stump,crossclassified,1,0,1
14085,canister,holder,crossclassified,1,1,0
15694,knife,tray,crossclassified,1,1,0
15695,bun,knife,crossclassified,1,0,1
14069,barrel,stump,crossclassified,1,0,1
14514,dress,pant,crossclassified,1,1,0
14068,pipe,stump,crossclassified,1,0,1
14515,dress,paste,crossclassified,1,1,0
14516,dress,leg,crossclassified,1,1,0
14066,container,stump,crossclassified,1,0,1
14517,brushes,dress,crossclassified,1,0,1
14062,stump,trunk,co-hyponymy,1,1,0
15696,car,signal,crossclassified,1,1,0
14060,barn,pole,co-hyponymy,1,1,0
14059,barn,shack,crossclassified,1,1,0
14084,candle,canister,crossclassified,1,0,1
14086,canister,glass,co-hyponymy,1,1,0
14114,rail,skier,crossclassified,1,1,0
14498,highchair,woman,crossclassified,1,0,1
14113,boy,rail,crossclassified,1,0,1
14112,rail,shoe,crossclassified,1,1,0
14111,rail,railing,synonymy,1,1,0
14110,rail,snow,crossclassified,1,1,0
14109,rail,skating,crossclassified,1,1,0
14108,rail,slide,crossclassified,1,1,0
14106,rail,snowboarder,crossclassified,1,1,0
14495,shop,tent,crossclassified,1,0,1
14105,rail,shadow,crossclassified,1,1,0
14104,rail,skis,crossclassified,1,1,0
14496,tent,tire,crossclassified,1,1,0
14497,bottle,carpet,crossclassified,1,0,1
14101,chocolate,spoon,crossclassified,1,0,1
14099,blazer,curtain,crossclassified,1,0,1
14087,canister,storage,crossclassified,1,1,0
14499,spue,woman,crossclassified,1,0,1
14097,coat,curtain,crossclassified,1,0,1
14500,robe,woman,crossclassified,1,0,1
14094,hat,spectacle,crossclassified,1,1,0
14093,eyeglasses,hat,crossclassified,1,0,1
14092,highway,street,crossclassified,1,0,1
14501,tab,woman,crossclassified,1,0,1
14091,roadway,street,crossclassified,1,0,1
14090,bag,counter,crossclassified,1,0,1
14502,cereal,woman,crossclassified,1,0,1
14089,bowl,canister,co-hyponymy,1,0,1
14504,cabotage,door,crossclassified,1,0,1
14088,canister,furniture,crossclassified,1,1,0
13516,guy,shoe,crossclassified,1,0,1
13514,bucket,trash,crossclassified,1,1,0
15081,boy,joystick,crossclassified,1,1,0
15523,hangar,plane,crossclassified,1,0,1
12914,continental,counter,crossclassified,1,0,1
12913,bread,paganini,crossclassified,1,1,0
12911,child,people,crossclassified,1,1,0
12910,child,father,crossclassified,1,1,0
12909,bird,child,crossclassified,1,0,1
14989,person,women,hypernymy.1,1,1,0
12905,rafter,woman,crossclassified,1,0,1
12904,cake,ta,crossclassified,1,1,0
12903,cake,toys,crossclassified,1,1,0
12902,cake,car,crossclassified,1,1,0
14991,cup,truck,crossclassified,1,0,1
12900,bench,picture,crossclassified,1,1,0
12899,basin,shirt,crossclassified,1,0,1
14993,man,slipper,co-hyponymy,1,1,0
12898,cookie,pancake,co-hyponymy,1,0,1
14994,handbag,man,crossclassified,1,0,1
14995,floor,stepper,crossclassified,1,1,0
12896,mouse,pat,crossclassified,1,1,0
12895,tag,woman,crossclassified,1,0,1
12894,headscarf,woman,crossclassified,1,0,1
15526,backpack,beg,crossclassified,1,1,0
12893,hello,shirt,crossclassified,1,0,1
14996,floor,office,crossclassified,1,1,0
12892,castle,palace,synonymy,1,1,0
15524,beans,table,crossclassified,1,0,1
12889,headwaiter,woman,crossclassified,1,0,1
14998,sandbar,shore,crossclassified,1,0,1
14999,coastline,shore,crossclassified,1,0,1
12887,jacket,wineglass,crossclassified,1,1,0
12915,airplane,streetlights,crossclassified,1,1,0
12916,blank,man,crossclassified,1,0,1
12917,man,shoulder,crossclassified,1,1,0
12927,book,cabinet,crossclassified,1,0,1
12940,bundle,rhubarb,crossclassified,1,0,1
14978,floor,people,crossclassified,1,1,0
14979,floor,person,crossclassified,1,1,0
12938,kick,man,crossclassified,1,0,1
12937,fleece,shirt,crossclassified,1,0,1
12936,glove,skier,crossclassified,1,0,1
12935,curtain,soap,crossclassified,1,1,0
12934,curtain,hand,crossclassified,1,1,0
14980,crowd,floor,co-hyponymy,1,0,1
12932,boy,motorcycle,crossclassified,1,0,1
12931,jacket,leaf,crossclassified,1,1,0
12929,dress,jersey,crossclassified,1,0,1
12928,doors,house,crossclassified,1,0,1
14981,house,treetop,crossclassified,1,1,0
12918,gerfalcon,giraffe,crossclassified,1,0,1
15530,cabinet,wine,crossclassified,1,1,0
15529,cabinet,court,crossclassified,1,1,0
14982,bench,shaded,crossclassified,1,1,0
12925,fence,sheep,crossclassified,1,0,1
14983,body,horse,crossclassified,1,0,1
14984,boot,horse,crossclassified,1,0,1
12924,giraffe,log,crossclassified,1,1,0
12923,band,man,crossclassified,1,0,1
12922,buttonwood,shirt,crossclassified,1,0,1
12921,bench,woodman,crossclassified,1,1,0
12920,pet,shirt,crossclassified,1,0,1
14985,ice,tub,crossclassified,1,0,1
14986,hair,tub,crossclassified,1,0,1
12886,equestrian,horse,crossclassified,1,0,1
12885,house,shop,crossclassified,1,1,0
14977,floor,room,hypernymy.2,1,1,0
12884,fountain,house,crossclassified,1,0,1
12843,cone,dugout,crossclassified,1,0,1
12840,duck,water,crossclassified,1,1,0
12839,lade,person,crossclassified,1,0,1
12838,cowboy,person,hypernymy.2,1,0,1
12837,fighter,person,hypernymy.2,1,0,1
12835,appetizers,counter,crossclassified,1,0,1
12834,bottle,medicine,crossclassified,1,1,0
15780,catcher,guy,crossclassified,1,1,0
12833,bottle,chemical,crossclassified,1,1,0
15522,cat,gloves,crossclassified,1,1,0
12832,defender,woman,crossclassified,1,0,1
12831,airplane,hawaiian,crossclassified,1,1,0
12830,bent,rice,crossclassified,1,0,1
12829,food,sheep,crossclassified,1,0,1
12828,toothbrushes,woman,crossclassified,1,0,1
12827,pusher,woman,crossclassified,1,0,1
12826,teeth,woman,crossclassified,1,0,1
12824,sign,woman,crossclassified,1,0,1
12820,calf,giraffe,crossclassified,1,0,1
15008,bank,shore,crossclassified,1,0,1
15009,grasses,shore,crossclassified,1,0,1
12819,stems,vase,crossclassified,1,0,1
15010,plants,shore,crossclassified,1,0,1
12818,dress,flag,crossclassified,1,1,0
12817,doctor,woman,crossclassified,1,0,1
15011,mountain,shore,crossclassified,1,0,1
12815,logger,truck,crossclassified,1,0,1
15012,hill,shore,crossclassified,1,0,1
12814,bread,sneaks,crossclassified,1,1,0
12845,t-shirt,umbrella,crossclassified,1,0,1
12846,jump,woman,crossclassified,1,0,1
12847,man,sporting,crossclassified,1,1,0
12865,eyas,zebra,crossclassified,1,0,1
12883,canopy,house,crossclassified,1,0,1
12882,gherkin,man,crossclassified,1,0,1
15779,human,legs,crossclassified,1,0,1
12879,man,wheelchair,crossclassified,1,0,1
12878,drawing,man,crossclassified,1,0,1
12877,automobile,cow,crossclassified,1,0,1
12876,court,table,crossclassified,1,0,1
12875,man,senator,crossclassified,1,1,0
15001,shore,table,crossclassified,1,1,0
12874,suit,torso,crossclassified,1,1,0
12873,cat,meow,crossclassified,1,1,0
12871,church,steeple,crossclassified,1,1,0
12866,eyes,zebra,crossclassified,1,0,1
12863,cornbread,pie,crossclassified,1,0,1
12848,cake,sweet,crossclassified,1,1,0
12862,pie,tart,hypernymy.1,1,1,0
12861,bench,signpost,crossclassified,1,1,0
15003,riverbank,shore,crossclassified,1,0,1
12859,duchess,woman,crossclassified,1,0,1
15004,island,shore,crossclassified,1,0,1
12857,athletic,dugout,crossclassified,1,0,1
12856,programmer,woman,crossclassified,1,0,1
12855,cheek,shirt,crossclassified,1,0,1
12854,robe,towel,crossclassified,1,1,0
15006,bushes,shore,crossclassified,1,0,1
12852,face,house,crossclassified,1,0,1
12851,house,suit,crossclassified,1,1,0
12850,excitableness,salad,crossclassified,1,0,1
12941,rhubarb,stems,crossclassified,1,1,0
12943,plants,rhubarb,hypernymy.1,1,0,1
15013,shore,water,crossclassified,1,1,0
12998,boy,strap,crossclassified,1,1,0
14947,boy,mouth,crossclassified,1,1,0
13023,scarf,sweatshirt,crossclassified,1,0,1
13022,lap,sweatshirt,crossclassified,1,0,1
13020,goalie,shirt,crossclassified,1,0,1
13019,lore,rug,crossclassified,1,0,1
13018,carrier,woman,crossclassified,1,0,1
13017,bench,wallenstein,crossclassified,1,1,0
13016,bench,concrete,crossclassified,1,1,0
13015,plane,utter,crossclassified,1,1,0
13014,forte,table,crossclassified,1,0,1
14948,gold,woman,crossclassified,1,0,1
13013,girl,lade,crossclassified,1,1,0
15540,bridge,viaduct,hypernymy.1,1,1,0
14949,jewel,woman,crossclassified,1,0,1
14950,jewels,woman,crossclassified,1,0,1
15777,chair,mirror,crossclassified,1,1,0
14951,clew,man,crossclassified,1,0,1
13012,girl,headband,crossclassified,1,1,0
15539,couch,seniors,crossclassified,1,1,0
13011,plane,warplane,co-hyponymy,1,1,0
13010,shirt,talk,crossclassified,1,1,0
14952,sink,tiles,crossclassified,1,1,0
13008,bowtie,paper,crossclassified,1,1,0
13007,band,bowtie,crossclassified,1,0,1
13006,food,noodle,hypernymy.1,1,1,0
13005,clams,food,hypernymy.2,1,0,1
13004,food,seafood,hypernymy.1,1,1,0
14953,bench,pizza,crossclassified,1,1,0
13000,ring,sandwich,crossclassified,1,0,1
14946,garage,workmanship,crossclassified,1,1,0
13027,truck,zip,crossclassified,1,1,0
13028,cub,salad,crossclassified,1,0,1
14939,food,pinwheel,crossclassified,1,1,0
13052,roof,shack,crossclassified,1,1,0
13050,palm,roof,crossclassified,1,0,1
13049,bananas,roof,crossclassified,1,0,1
15773,man,printer,co-hyponymy,1,1,0
14934,couch,sofas,synonymy,1,1,0
13047,boat,sheet,crossclassified,1,1,0
15542,horse,snot,crossclassified,1,1,0
13046,boat,roof,crossclassified,1,1,0
14935,mirror,suit,crossclassified,1,0,1
14936,collar,suit,crossclassified,1,0,1
14937,oldwife,woman,crossclassified,1,0,1
13043,boat,cover,crossclassified,1,1,0
14938,bench,file,crossclassified,1,1,0
14940,food,ravioli,hypernymy.1,1,1,0
14944,board,garage,crossclassified,1,0,1
13039,floor,wheels,crossclassified,1,1,0
14941,cow,kayak,crossclassified,1,1,0
13037,floor,road,crossclassified,1,1,0
13036,floor,overboard,crossclassified,1,1,0
13034,dress,pitcher,crossclassified,1,0,1
15774,cap,chair,crossclassified,1,0,1
14942,cow,poor,crossclassified,1,1,0
13032,chest,train,crossclassified,1,0,1
13031,train,trunk,crossclassified,1,1,0
14943,garage,rope,crossclassified,1,1,0
13030,siding,train,crossclassified,1,0,1
15541,horse,stacte,crossclassified,1,1,0
15776,car,hat,crossclassified,1,1,0
12999,hands,sandwich,crossclassified,1,0,1
12997,person,skirt,hypernymy.1,1,1,0
12945,microwave,rhubarb,crossclassified,1,0,1
15538,couch,elders,crossclassified,1,1,0
14965,shirt,sweets,crossclassified,1,1,0
12969,cumberland,jacket,crossclassified,1,0,1
12967,cottage,shed,crossclassified,1,0,1
14966,brick,motorcycle,crossclassified,1,0,1
12966,jacket,jeer,crossclassified,1,1,0
12965,man,sock,crossclassified,1,1,0
12964,fettuccine,pasta,hypernymy.2,1,0,1
12963,cakes,counter,crossclassified,1,0,1
15532,scooter,vesicular,crossclassified,1,1,0
12962,counter,kob,crossclassified,1,1,0
12961,counter,product,crossclassified,1,1,0
14967,bowl,mango,crossclassified,1,1,0
12960,counter,refrigerator,crossclassified,1,1,0
12959,counter,store,crossclassified,1,1,0
15531,motor,scooter,crossclassified,1,0,1
14968,building,chalet,hypernymy.1,1,1,0
14970,girl,swimming,crossclassified,1,1,0
12958,enjoyment,girl,crossclassified,1,0,1
12956,iron,woman,crossclassified,1,0,1
12955,chimney,house,crossclassified,1,0,1
14971,girl,water,crossclassified,1,1,0
12954,entertainer,jacket,crossclassified,1,0,1
14972,cat,softball,crossclassified,1,1,0
12952,bratwurst,grill,crossclassified,1,0,1
14974,floor,store,crossclassified,1,1,0
12949,reckless,woman,crossclassified,1,0,1
12948,jacket,scooter,crossclassified,1,0,1
12947,appetizer,bowl,crossclassified,1,0,1
14975,floor,mall,crossclassified,1,1,0
12971,hamster,rabbit,crossclassified,1,1,0
12972,hamster,pet,crossclassified,1,1,0
12974,hamster,wood,crossclassified,1,1,0
14957,key,shirt,crossclassified,1,0,1
12996,bull,sheep,crossclassified,1,0,1
12995,chair,dewy,crossclassified,1,1,0
12994,chair,toys,crossclassified,1,1,0
15537,hie,woman,crossclassified,1,0,1
15659,spiller,vase,crossclassified,1,0,1
14954,bowl,coke,crossclassified,1,1,0
15536,car,pants,crossclassified,1,1,0
15535,car,legs,crossclassified,1,1,0
14955,girl,youth,crossclassified,1,1,0
14956,girl,wooden,crossclassified,1,1,0
15534,shirt,suits,co-hyponymy,1,1,0
12990,cafeteria,counter,crossclassified,1,0,1
15533,hire,shirt,crossclassified,1,0,1
12985,bridge,trafficator,crossclassified,1,1,0
14964,adrianople,airplane,crossclassified,1,0,1
12984,man,play,crossclassified,1,1,0
14958,band,shirt,crossclassified,1,0,1
14960,post,tower,crossclassified,1,0,1
14961,tower,tree,crossclassified,1,1,0
12982,entree,rice,crossclassified,1,0,1
14962,lighthouse,tower,hypernymy.2,1,0,1
12981,beef,rice,crossclassified,1,0,1
12979,chair,grandpa,crossclassified,1,1,0
12978,apples,food,hypernymy.2,1,0,1
12977,glove,pitcher,crossclassified,1,0,1
14963,pinnacle,tower,hypernymy.2,1,0,1
12976,bottle,dog,crossclassified,1,0,1
12975,dress,microphone,crossclassified,1,1,0
12813,berry,cake,crossclassified,1,0,1
15014,food,protein,crossclassified,1,1,0
13513,bucket,morale,crossclassified,1,1,0
15063,chert,tie,crossclassified,1,0,1
12638,brits,cabinet,crossclassified,1,0,1
15512,bunked,kid,crossclassified,1,1,0
12636,cabinet,store,crossclassified,1,1,0
12633,curtain,flush,crossclassified,1,1,0
15511,bunk,bunked,crossclassified,1,0,1
12630,net,wall,crossclassified,1,0,1
12629,drapes,wall,crossclassified,1,0,1
12628,cloth,wall,crossclassified,1,0,1
15056,bed,lips,crossclassified,1,1,0
15057,bed,mouth,crossclassified,1,1,0
15058,bed,guy,crossclassified,1,1,0
15510,bunked,chair,crossclassified,1,1,0
15059,bed,cushions,hypernymy.1,1,1,0
15060,stall,umbrella,crossclassified,1,0,1
12623,table,tortillas,crossclassified,1,1,0
12622,lid,table,crossclassified,1,0,1
12621,bench,gravestone,crossclassified,1,1,0
12620,bench,headstone,crossclassified,1,1,0
12619,curtain,cycle,crossclassified,1,1,0
15061,rope,umbrella,crossclassified,1,0,1
12618,table,vessels,crossclassified,1,1,0
15509,bunked,roof,crossclassified,1,1,0
15062,booth,umbrella,crossclassified,1,0,1
12616,cabinet,woodman,crossclassified,1,1,0
12615,chair,decoration,crossclassified,1,1,0
15508,bunked,table,crossclassified,1,1,0
12614,cause,table,crossclassified,1,0,1
12613,chair,patient,crossclassified,1,1,0
12611,highchair,table,crossclassified,1,1,0
12639,cabinet,juice,crossclassified,1,1,0
15055,child,custom,crossclassified,1,1,0
12640,tile,wheelchair,crossclassified,1,0,1
12654,desk,duplicator,crossclassified,1,1,0
15047,mobile,taxi,crossclassified,1,0,1
12671,chair,towel,crossclassified,1,1,0
12670,brush,chair,crossclassified,1,0,1
15048,shirt,taxi,crossclassified,1,0,1
12663,brush,curtain,crossclassified,1,0,1
12662,rug,train,crossclassified,1,1,0
12661,couch,oafs,crossclassified,1,1,0
12660,cosmetics,dresser,crossclassified,1,0,1
12658,mad,rug,crossclassified,1,0,1
12657,pans,table,crossclassified,1,0,1
15049,dress,taxi,crossclassified,1,0,1
12656,couch,ear,crossclassified,1,1,0
12655,couch,train,crossclassified,1,1,0
12653,bedframe,floor,crossclassified,1,0,1
12641,vehicle,wheelchair,crossclassified,1,0,1
15514,candy,shirt,crossclassified,1,0,1
12652,bedspread,floor,crossclassified,1,0,1
15787,building,plate,crossclassified,1,1,0
12650,bench,plain,crossclassified,1,1,0
15050,taxi,vehicle,hypernymy.2,1,1,0
15051,cabinet,snakes,crossclassified,1,1,0
12648,curtain,knob,crossclassified,1,1,0
12647,table,toppings,crossclassified,1,1,0
15052,cabinet,coke,crossclassified,1,1,0
12644,chair,display,crossclassified,1,1,0
12643,carpeting,rug,synonymy,1,0,1
12642,door,floor,co-hyponymy,1,0,1
15053,cabinet,foods,crossclassified,1,1,0
12610,highchair,infant,crossclassified,1,1,0
15064,coaches,train,co-hyponymy,1,0,1
12673,pored,table,crossclassified,1,0,1
15065,coke,hotdog,crossclassified,1,0,1
12565,desk,sculpture,crossclassified,1,1,0
12564,cecal,desk,crossclassified,1,0,1
15790,leek,veggie,hypernymy.2,1,1,0
12563,eggs,table,crossclassified,1,0,1
15503,scooter,snotty,crossclassified,1,1,0
12559,floor,piano,crossclassified,1,1,0
12558,bench,hat,crossclassified,1,1,0
15071,boy,stick,crossclassified,1,1,0
12557,bench,cement,crossclassified,1,1,0
15072,food,lachesis,crossclassified,1,1,0
12556,couch,headboard,crossclassified,1,1,0
15073,food,weimaraner,crossclassified,1,1,0
12555,couch,sheet,crossclassified,1,1,0
12554,bed,lighting,crossclassified,1,1,0
12553,crib,furniture,hypernymy.2,1,1,0
15074,bridge,shop,crossclassified,1,1,0
15075,bridge,trees,crossclassified,1,1,0
12549,crib,t-shirt,crossclassified,1,1,0
15501,girl,yoga,crossclassified,1,1,0
15077,desk,pants,crossclassified,1,1,0
12546,booth,teenager,crossclassified,1,1,0
12545,booth,food,crossclassified,1,1,0
12544,booth,t-shirt,crossclassified,1,1,0
15500,veils,woman,crossclassified,1,0,1
12541,carpet,poster,crossclassified,1,1,0
12540,screen,sink,crossclassified,1,0,1
12537,chest,counter,co-hyponymy,1,0,1
15079,clothes,dugout,crossclassified,1,0,1
15080,boy,cheese,crossclassified,1,1,0
15069,files,jacket,crossclassified,1,0,1
15504,couch,some,crossclassified,1,1,0
12567,dresser,shelve,crossclassified,1,1,0
12585,cabinet,sing,crossclassified,1,1,0
12606,coke,couch,crossclassified,1,0,1
12602,counter,snack,crossclassified,1,1,0
12601,champagne,table,crossclassified,1,0,1
12600,chair,elbow,crossclassified,1,1,0
12599,chair,sleeve,crossclassified,1,1,0
12598,floor,system,crossclassified,1,1,0
12597,counter,lettuce,crossclassified,1,1,0
12593,luggage,seat,crossclassified,1,0,1
12592,seat,tile,crossclassified,1,1,0
12590,couch,pose,crossclassified,1,1,0
12588,beach,stone,crossclassified,1,1,0
12587,beach,ocean,crossclassified,1,1,0
12586,beach,rock,crossclassified,1,1,0
12584,cabinet,kid,crossclassified,1,1,0
12568,dresser,shoe,crossclassified,1,1,0
12583,cabinet,cap,crossclassified,1,1,0
12581,cabinet,spoon,crossclassified,1,1,0
12579,cabinet,cake,crossclassified,1,1,0
15067,fork,napkin,crossclassified,1,1,0
12577,cabinet,collectable,crossclassified,1,1,0
15068,fork,sweet,crossclassified,1,1,0
12576,cabinet,credenza,crossclassified,1,1,0
12575,cabinet,pot,crossclassified,1,1,0
12574,buffet,cabinet,co-hyponymy,1,0,1
12572,counter,teapot,crossclassified,1,1,0
12571,desk,house,crossclassified,1,1,0
15505,boy,dude,co-hyponymy,1,1,0
12569,counter,holder,crossclassified,1,1,0
12672,bar,bench,crossclassified,1,0,1
12674,grinds,table,crossclassified,1,0,1
12812,horse,ranch,crossclassified,1,1,0
15032,goal,nature,crossclassified,1,1,0
12777,giraffe,mammal,hypernymy.2,1,1,0
12776,cup,toothpaste,crossclassified,1,1,0
12775,tercentennial,woman,crossclassified,1,0,1
12774,microvolt,table,crossclassified,1,0,1
12773,avon,table,crossclassified,1,0,1
12772,fruit,jacket,crossclassified,1,0,1
15023,goal,shirt,crossclassified,1,1,0
15024,goal,net,hypernymy.1,1,1,0
12769,boat,pad,crossclassified,1,1,0
12768,counter,humans,crossclassified,1,1,0
12767,counter,men,co-hyponymy,1,1,0
12764,muffin,vegetable,crossclassified,1,1,0
12763,muffin,plate,crossclassified,1,1,0
12761,broccoli,muffin,crossclassified,1,0,1
12760,skier,sweatshirt,crossclassified,1,1,0
15026,chain,goal,crossclassified,1,0,1
12758,building,hamate,crossclassified,1,1,0
15027,goal,lantern,crossclassified,1,1,0
12756,bread,vegetable,crossclassified,1,1,0
12755,bread,things,crossclassified,1,1,0
12754,birdbath,table,crossclassified,1,1,0
15028,goal,umbrella,crossclassified,1,1,0
12752,basin,birdbath,hypernymy.1,1,0,1
12750,birdbath,sink,crossclassified,1,1,0
15029,goal,trap,crossclassified,1,1,0
12748,moviegoer,woman,crossclassified,1,0,1
12747,crowd,woman,crossclassified,1,0,1
12746,fruit,juicer,crossclassified,1,0,1
12745,juicer,plate,crossclassified,1,1,0
12778,greybeard,woman,crossclassified,1,0,1
12779,tank,truck,crossclassified,1,0,1
12780,chair,sneaker,crossclassified,1,1,0
15017,controls,desk,crossclassified,1,0,1
12811,bear,doll,crossclassified,1,1,0
12810,bear,scarf,crossclassified,1,1,0
15015,airplane,food,crossclassified,1,0,1
12808,bear,sculpture,crossclassified,1,1,0
12807,dugout,umpire,crossclassified,1,1,0
12805,giraffe,train,crossclassified,1,1,0
12804,boat,person,crossclassified,1,0,1
12803,person,sea,crossclassified,1,1,0
12802,dude,person,hypernymy.2,1,0,1
15781,giraffe,gripe,crossclassified,1,1,0
15016,tattoo,woman,crossclassified,1,0,1
12801,person,shadow,hypernymy.1,1,1,0
12800,pan,pasha,crossclassified,1,1,0
12798,macaroni,pan,crossclassified,1,0,1
12781,antenna,lamp,crossclassified,1,0,1
12797,bike,umbrella,crossclassified,1,0,1
15018,controllable,desk,crossclassified,1,0,1
12796,airplane,umbrella,crossclassified,1,0,1
12795,curry,sandwich,crossclassified,1,0,1
15019,desk,panel,crossclassified,1,1,0
12792,jacket,sleeves,crossclassified,1,1,0
15020,van,veils,crossclassified,1,1,0
12790,building,steeple,crossclassified,1,1,0
12789,jar,man,crossclassified,1,0,1
12788,cereal,plate,crossclassified,1,1,0
12787,cereal,milk,co-hyponymy,1,1,0
12783,bear,deer,crossclassified,1,1,0
12782,bear,gorilla,crossclassified,1,1,0
12744,juicer,squeezer,hypernymy.2,1,1,0
15033,goal,pole,co-hyponymy,1,1,0
12675,carpet,tables,crossclassified,1,1,0
12742,cup,juicer,crossclassified,1,0,1
12702,cow,stable,crossclassified,1,1,0
15038,biltong,building,crossclassified,1,0,1
12701,back,man,crossclassified,1,0,1
15039,clothe,shirt,crossclassified,1,0,1
12699,child,giraffe,crossclassified,1,1,0
15784,class,skier,crossclassified,1,0,1
12698,child,female,co-hyponymy,1,1,0
12697,midsection,shirt,crossclassified,1,0,1
15040,lade,shirt,crossclassified,1,0,1
15519,couch,mike,crossclassified,1,1,0
12692,carpet,cubby,crossclassified,1,1,0
15041,dog,umbrella,crossclassified,1,1,0
12690,burner,table,crossclassified,1,0,1
15042,competitor,dog,crossclassified,1,0,1
12688,hamburger,table,crossclassified,1,0,1
12686,carpet,placeman,crossclassified,1,1,0
15517,bird,goldfinch,hypernymy.1,1,1,0
12685,bench,tablet,crossclassified,1,1,0
12684,cabinet,hair,crossclassified,1,1,0
12682,bed,rope,crossclassified,1,1,0
15043,skier,wheel,crossclassified,1,1,0
15044,pizza,wheel,crossclassified,1,1,0
15045,man,sit,crossclassified,1,1,0
15515,house,volleyball,crossclassified,1,1,0
15046,t-shirt,taxi,crossclassified,1,0,1
12679,bed,twined,crossclassified,1,1,0
12678,boom,rug,crossclassified,1,0,1
12677,desk,station,crossclassified,1,1,0
12676,capote,counter,crossclassified,1,0,1
12703,desk,keelboat,crossclassified,1,1,0
12704,costume,house,crossclassified,1,0,1
12706,house,vest,crossclassified,1,1,0
15035,goal,lamp,crossclassified,1,1,0
12741,food,juicer,crossclassified,1,0,1
15034,goal,stick,crossclassified,1,1,0
12739,blazer,dress,crossclassified,1,0,1
15521,boy,class,crossclassified,1,1,0
12738,image,man,co-hyponymy,1,0,1
12737,pepper,pizza,crossclassified,1,0,1
12735,motorcycle,van,crossclassified,1,0,1
12734,carpet,men,crossclassified,1,1,0
12733,carpet,jeans,crossclassified,1,1,0
12731,engine,man,crossclassified,1,0,1
15783,desk,game,crossclassified,1,1,0
12729,class,shower,crossclassified,1,0,1
12727,camera,shower,crossclassified,1,0,1
12725,cadet,man,crossclassified,1,0,1
12707,bookshelf,slap,crossclassified,1,1,0
12724,bowl,vessel,hypernymy.2,1,1,0
12722,motorcycle,vesical,crossclassified,1,1,0
15036,airplane,empennage,crossclassified,1,1,0
12720,crib,pillow,crossclassified,1,1,0
12719,humans,man,synonymy,1,0,1
12717,bench,food,crossclassified,1,1,0
12715,bulgur,sausage,crossclassified,1,0,1
12714,hotdogs,sausage,hypernymy.2,1,0,1
12713,noodles,sausage,crossclassified,1,0,1
12712,dinner,sausage,crossclassified,1,0,1
15037,bull,dear,crossclassified,1,1,0
12710,helicopter,wing,crossclassified,1,0,1
12709,cow,elk,crossclassified,1,1,0
14933,doggie,sandwich,crossclassified,1,0,1
13053,leaf,roof,crossclassified,1,0,1
14932,counter,snowboard,crossclassified,1,1,0
13350,leatherjacket,shirt,crossclassified,1,0,1
13378,boy,brownshirt,crossclassified,1,1,0
13377,pinstripes,zebra,crossclassified,1,0,1
14814,moselle,woman,crossclassified,1,0,1
13376,hotdog,package,crossclassified,1,1,0
14815,carpet,motorbike,crossclassified,1,1,0
13375,horse,sand,crossclassified,1,1,0
13373,bottle,person,crossclassified,1,0,1
13371,bench,bookshelf,crossclassified,1,0,1
13370,bird,deer,crossclassified,1,1,0
13369,child,stove,crossclassified,1,1,0
14816,carpet,tyre,crossclassified,1,1,0
13368,fork,veggies,crossclassified,1,1,0
13367,cow,cowardliness,crossclassified,1,1,0
13366,man,wireman,co-hyponymy,1,1,0
13365,cowgirl,horse,crossclassified,1,0,1
15752,dugout,shade,crossclassified,1,1,0
15753,bedding,cat,crossclassified,1,0,1
13361,chair,lamp,crossclassified,1,0,1
14817,carpet,skull,crossclassified,1,1,0
14818,carpet,display,crossclassified,1,1,0
13360,cup,sorbet,crossclassified,1,1,0
13358,boy,chapel,crossclassified,1,1,0
13356,cow,horns,crossclassified,1,1,0
15754,gamer,girl,crossclassified,1,0,1
15755,boat,torso,crossclassified,1,1,0
14819,carpet,vehicle,crossclassified,1,1,0
13354,bird,girl,hypernymy.2,1,1,0
14820,thereto,woman,crossclassified,1,0,1
13353,bird,pellicle,crossclassified,1,1,0
14813,slop,table,crossclassified,1,0,1
14812,alate,salad,crossclassified,1,0,1
14810,t-shirt,toddler,crossclassified,1,1,0
13393,furniture,train,crossclassified,1,0,1
13405,eyeballs,jacket,crossclassified,1,0,1
13404,cow,skirt,crossclassified,1,1,0
13403,cow,girl,crossclassified,1,1,0
13402,goth,man,crossclassified,1,0,1
13401,fork,plat,crossclassified,1,1,0
13400,vehicle,wing,crossclassified,1,0,1
14803,awning,marquee,co-hyponymy,1,1,0
13399,dog,skateboarder,crossclassified,1,1,0
14804,awning,brand,crossclassified,1,1,0
13397,artwork,dog,crossclassified,1,0,1
13396,dog,ski,crossclassified,1,1,0
13395,stand,train,crossclassified,1,0,1
13394,fruits,train,co-hyponymy,1,0,1
13392,bird,train,crossclassified,1,0,1
13380,skater,sneaker,crossclassified,1,1,0
13391,calf,house,crossclassified,1,0,1
13390,child,switch,crossclassified,1,1,0
13389,giraffe,rock,crossclassified,1,1,0
15751,chair,tress,crossclassified,1,1,0
14807,giraffe,pant,crossclassified,1,1,0
13388,lady,skater,crossclassified,1,0,1
13387,drawing,table,crossclassified,1,0,1
14808,beast,giraffe,hypernymy.1,1,0,1
13384,couple,surfer,crossclassified,1,0,1
13383,dolce,donut,crossclassified,1,0,1
13382,shoes,skateboarder,crossclassified,1,0,1
14809,kid,t-shirt,crossclassified,1,0,1
13381,skater,slacks,crossclassified,1,1,0
14821,suit,tiered,crossclassified,1,1,0
14824,class,couch,crossclassified,1,0,1
14802,awning,signage,crossclassified,1,1,0
13348,bed,cats,crossclassified,1,1,0
15756,seat,t-shirt,crossclassified,1,1,0
14835,car,statue,crossclassified,1,1,0
13318,betrothal,bus,crossclassified,1,0,1
14836,car,water,crossclassified,1,1,0
13317,bus,overview,crossclassified,1,1,0
14837,car,iron,crossclassified,1,1,0
14838,oven,shirt,crossclassified,1,0,1
13316,cake,fish,crossclassified,1,0,1
13315,fish,lama,crossclassified,1,1,0
15566,skateboarder,statue,crossclassified,1,0,1
13314,bun,fish,crossclassified,1,0,1
14839,dugout,potsherd,crossclassified,1,1,0
14840,allay,dugout,crossclassified,1,0,1
13306,jacket,longboat,crossclassified,1,1,0
13305,giraffe,mirror,crossclassified,1,1,0
13302,gazebo,hut,crossclassified,1,0,1
13301,bench,hut,crossclassified,1,0,1
15758,furniture,seat,hypernymy.1,1,0,1
14841,drink,mug,crossclassified,1,0,1
13300,necker,shirt,crossclassified,1,0,1
13299,chair,foot,crossclassified,1,1,0
14844,cabinet,ire,crossclassified,1,1,0
13298,chair,chairperson,synonymy,1,1,0
13297,auditorium,dugout,crossclassified,1,0,1
13296,donut,meat,crossclassified,1,1,0
14845,cabinet,draw,crossclassified,1,1,0
14846,boy,foot,crossclassified,1,1,0
14847,bench,mattress,crossclassified,1,1,0
14848,bench,daybed,crossclassified,1,1,0
13319,chesterton,sandwich,crossclassified,1,0,1
13320,surfer,waterside,crossclassified,1,1,0
13322,pottery,table,crossclassified,1,0,1
13337,brush,toy,crossclassified,1,0,1
13347,cover,roof,hypernymy.1,1,0,1
13346,armada,roof,crossclassified,1,0,1
13345,deck,roof,crossclassified,1,0,1
15572,bridge,tresses,crossclassified,1,1,0
15570,skater,statue,crossclassified,1,0,1
14825,couch,eyeglasses,crossclassified,1,1,0
14826,top,vest,crossclassified,1,0,1
13344,gazebo,roof,crossclassified,1,0,1
15569,shoe,statue,crossclassified,1,0,1
14827,boy,diner,crossclassified,1,1,0
13339,burger,dog,crossclassified,1,0,1
14828,jacket,toys,crossclassified,1,1,0
14829,jacket,medal,crossclassified,1,1,0
13335,shower,table,crossclassified,1,1,0
13323,jumper,woman,crossclassified,1,0,1
13334,donut,fritter,co-hyponymy,1,1,0
13333,brick,building,crossclassified,1,0,1
13331,archway,building,crossclassified,1,0,1
13330,building,fireplace,crossclassified,1,1,0
13329,dress,lingerie,crossclassified,1,1,0
14830,gun,jacket,crossclassified,1,0,1
13327,table,teeth,crossclassified,1,1,0
13326,bread,child,crossclassified,1,0,1
15568,kid,statue,crossclassified,1,0,1
14831,girl,sink,crossclassified,1,1,0
15567,human,statue,crossclassified,1,0,1
13325,bowtie,hat,crossclassified,1,0,1
14832,girl,heater,crossclassified,1,1,0
13406,cookies,hotdog,crossclassified,1,0,1
14801,awning,bods,crossclassified,1,1,0
14931,counter,skateboard,crossclassified,1,1,0
13456,bridge,glass,crossclassified,1,1,0
14762,cab,woman,crossclassified,1,0,1
13487,jacket,scatting,crossclassified,1,1,0
15580,bride,nickels,crossclassified,1,1,0
15579,bride,wife,crossclassified,1,1,0
13484,desk,winnows,crossclassified,1,1,0
13482,flooding,salad,crossclassified,1,0,1
13480,bear,koala,crossclassified,1,1,0
13477,robe,shawl,crossclassified,1,1,0
13475,costume,robe,crossclassified,1,0,1
14763,pizzeria,woman,crossclassified,1,0,1
13474,robe,stick,crossclassified,1,1,0
13473,pole,robe,crossclassified,1,0,1
14764,dugout,pump,crossclassified,1,1,0
15578,bride,tie,crossclassified,1,1,0
13470,man,napkin,crossclassified,1,1,0
13469,man,veg,crossclassified,1,1,0
13468,centerpiece,table,crossclassified,1,0,1
14765,dugout,iron,crossclassified,1,1,0
13466,couch,fruits,crossclassified,1,1,0
13464,lorry,trailer,crossclassified,1,0,1
14766,dugout,watch,crossclassified,1,1,0
13463,flatbed,trailer,crossclassified,1,0,1
14767,dugout,gerund,crossclassified,1,1,0
13462,trailer,vehicle,hypernymy.2,1,1,0
13461,pallet,trailer,crossclassified,1,0,1
14768,joystick,man,crossclassified,1,0,1
13460,trailer,wagon,co-hyponymy,1,1,0
13459,pole,trailer,crossclassified,1,0,1
14769,cower,dress,crossclassified,1,0,1
13490,shirt,wristband,crossclassified,1,1,0
13491,boy,cloth,crossclassified,1,1,0
15581,bride,join,crossclassified,1,1,0
14756,carpet,ears,crossclassified,1,1,0
13512,bucket,umbrella,crossclassified,1,1,0
15740,grill,hamburger,crossclassified,1,1,0
15741,boat,shapes,crossclassified,1,1,0
15742,jar,oil,crossclassified,1,1,0
13510,drinking,woman,crossclassified,1,0,1
15743,jar,liquid,crossclassified,1,1,0
13509,frisbee,jacket,crossclassified,1,0,1
14753,parka,woman,crossclassified,1,0,1
15744,board,skater,crossclassified,1,0,1
13506,movers,truck,crossclassified,1,0,1
15583,pored,surfer,crossclassified,1,0,1
14754,carpet,handbag,crossclassified,1,1,0
14755,carpet,zipper,crossclassified,1,1,0
15582,bed,human,crossclassified,1,1,0
13493,mirror,restaurant,crossclassified,1,0,1
13503,truck,wooden,crossclassified,1,1,0
13502,cabinet,truck,crossclassified,1,0,1
13500,counter,cutter,crossclassified,1,1,0
13499,jacket,tishri,crossclassified,1,1,0
13498,restaurant,train,crossclassified,1,1,0
13497,light,restaurant,crossclassified,1,0,1
13496,fence,restaurant,crossclassified,1,0,1
15745,shirty,skater,crossclassified,1,0,1
14758,beagle,dog,hypernymy.2,1,0,1
14759,child,foot,crossclassified,1,1,0
13495,people,restaurant,crossclassified,1,0,1
13494,jacket,restaurant,crossclassified,1,0,1
14761,child,eating,crossclassified,1,1,0
13457,bridge,floor,co-hyponymy,1,1,0
14770,bench,class,crossclassified,1,1,0
15574,all,bride,crossclassified,1,0,1
13455,broccoli,sandwich,crossclassified,1,1,0
13430,bread,meal,crossclassified,1,1,0
14786,lamp,restaurant,crossclassified,1,0,1
13429,car,traffic,crossclassified,1,1,0
14788,fruits,restaurant,crossclassified,1,0,1
13428,car,graffiti,crossclassified,1,1,0
13427,car,eel,crossclassified,1,1,0
13426,car,tub,crossclassified,1,1,0
14789,entryway,restaurant,crossclassified,1,0,1
13425,bottle,car,crossclassified,1,0,1
13424,car,nameplate,crossclassified,1,1,0
13423,temple,unknown,crossclassified,1,1,0
13422,church,temple,co-hyponymy,1,0,1
13421,bangkok,temple,crossclassified,1,0,1
13420,castle,temple,crossclassified,1,0,1
14791,pumpkin,restaurant,crossclassified,1,0,1
13418,temple,window,crossclassified,1,1,0
13417,pole,temple,crossclassified,1,0,1
13414,boy,seats,crossclassified,1,1,0
13413,cat,sunglasses,crossclassified,1,1,0
13412,cooker,kettle,crossclassified,1,0,1
15750,building,cage,crossclassified,1,1,0
14793,flight,woman,crossclassified,1,0,1
14794,ford,table,crossclassified,1,0,1
13410,jug,kettle,co-hyponymy,1,0,1
13409,bunk,man,crossclassified,1,0,1
14795,jacket,snowman,crossclassified,1,1,0
14797,boy,coke,crossclassified,1,1,0
13407,man,tell,crossclassified,1,1,0
14799,carpet,house,crossclassified,1,1,0
14785,restaurant,roofed,crossclassified,1,1,0
13431,drinks,jacket,crossclassified,1,0,1
13432,food,panicking,crossclassified,1,1,0
13444,floor,sink,crossclassified,1,1,0
14771,child,shofar,crossclassified,1,1,0
13454,broccoli,chinese,crossclassified,1,1,0
13452,airplane,delta,crossclassified,1,1,0
13451,car,date,crossclassified,1,1,0
13450,motorcycle,wile,crossclassified,1,1,0
14772,samara,suit,crossclassified,1,0,1
14773,pillow,tub,crossclassified,1,0,1
13448,bread,spinach,crossclassified,1,1,0
13447,truck,wile,crossclassified,1,1,0
14774,ship,tyre,crossclassified,1,1,0
14776,motorbike,window,crossclassified,1,0,1
14777,covering,window,crossclassified,1,0,1
15575,bride,cake,crossclassified,1,1,0
14779,stall,window,crossclassified,1,0,1
13433,cat,rotten,crossclassified,1,1,0
13443,bath,floor,co-hyponymy,1,0,1
15748,building,skate,crossclassified,1,1,0
14781,shoe,window,crossclassified,1,0,1
14782,sonic,window,crossclassified,1,0,1
13441,dress,hands,crossclassified,1,1,0
13440,buyer,man,crossclassified,1,0,1
14783,girl,roofed,crossclassified,1,1,0
13439,food,highchair,crossclassified,1,0,1
13438,cup,highchair,crossclassified,1,0,1
13437,highchair,person,crossclassified,1,1,0
13435,table,van,crossclassified,1,0,1
13434,mechanic,van,crossclassified,1,0,1
14784,furtive,girl,crossclassified,1,0,1
14849,potboy,sandwich,crossclassified,1,0,1
13293,grapes,jar,crossclassified,1,0,1
15759,girl,seat,crossclassified,1,0,1
13115,snowboarder,sweater,crossclassified,1,1,0
13140,chips,hotdog,crossclassified,1,0,1
13138,beaver,squirrel,co-hyponymy,1,0,1
13137,fork,vegetable,crossclassified,1,1,0
13136,cogitable,fork,crossclassified,1,0,1
14904,books,couch,crossclassified,1,0,1
14905,band,couch,crossclassified,1,0,1
13132,dog,reindeer,crossclassified,1,1,0
14907,sheep,snow,crossclassified,1,1,0
13131,lady,snowboarder,crossclassified,1,0,1
13130,showgirl,snowboarder,crossclassified,1,0,1
13129,counter,kerchief,crossclassified,1,1,0
14909,armchair,bench,crossclassified,1,0,1
14910,child,paste,crossclassified,1,1,0
13127,eater,girl,crossclassified,1,0,1
14911,chair,drawing,crossclassified,1,1,0
13126,headphones,skater,crossclassified,1,0,1
15769,clock,windowpane,crossclassified,1,1,0
13124,bawl,boat,crossclassified,1,0,1
13123,reader,woman,crossclassified,1,0,1
13122,cardigan,vest,crossclassified,1,0,1
13121,candles,spoon,crossclassified,1,0,1
14913,cake,mate,crossclassified,1,1,0
14914,cake,foods,hypernymy.2,1,1,0
13120,plane,statue,crossclassified,1,1,0
13119,girl,trees,crossclassified,1,1,0
13118,girl,organizer,crossclassified,1,1,0
15549,display,floor,crossclassified,1,0,1
14915,bartender,woman,crossclassified,1,0,1
13117,tent,umbellate,crossclassified,1,1,0
13141,sandwich,sofa,crossclassified,1,1,0
13142,flier,woman,crossclassified,1,0,1
14901,pored,sign,crossclassified,1,0,1
13157,racer,skateboarder,crossclassified,1,0,1
14891,art,elephant,crossclassified,1,0,1
13172,elephant,jacket,crossclassified,1,0,1
13171,cabinet,washstand,co-hyponymy,1,1,0
13170,laugh,woman,crossclassified,1,0,1
13169,burger,cookie,crossclassified,1,0,1
13168,cookie,whoopee,crossclassified,1,1,0
13166,headband,tie,crossclassified,1,0,1
13165,bowl,passe,crossclassified,1,1,0
13164,bird,bowl,crossclassified,1,0,1
14896,clothing,elephant,crossclassified,1,0,1
13160,organizer,woman,crossclassified,1,0,1
13159,bed,bus,crossclassified,1,0,1
13158,chair,robe,crossclassified,1,1,0
13156,local,man,crossclassified,1,0,1
15550,jacket,wedding,crossclassified,1,1,0
13155,bottle,flowerpot,crossclassified,1,1,0
15551,chine,food,hypernymy.2,1,0,1
13154,glass,guacamole,crossclassified,1,0,1
14898,girl,ties,crossclassified,1,1,0
13153,bowl,guacamole,crossclassified,1,0,1
13151,guacamole,salad,crossclassified,1,1,0
14899,boy,cabs,crossclassified,1,1,0
14900,car,umbellate,crossclassified,1,1,0
13148,guy,sweatshirt,crossclassified,1,0,1
13147,sweatshirt,torso,crossclassified,1,1,0
13146,forklift,truck,crossclassified,1,0,1
13145,cabinet,persuasion,crossclassified,1,1,0
13144,cabinet,marble,crossclassified,1,1,0
13116,dugout,fencing,crossclassified,1,1,0
15548,floor,kitchen,co-hyponymy,1,1,0
15565,statue,t-shirt,crossclassified,1,1,0
14916,cubs,dress,crossclassified,1,0,1
13081,dog,rack,co-hyponymy,1,0,1
14926,oven,tael,crossclassified,1,1,0
13079,cage,rack,crossclassified,1,0,1
14927,appliance,oven,hypernymy.1,1,0,1
14928,bridge,oven,crossclassified,1,0,1
13077,table,tub,crossclassified,1,1,0
13076,car,petrol,crossclassified,1,1,0
15545,boat,war,crossclassified,1,1,0
13075,coat,food,crossclassified,1,1,0
13074,dog,skater,crossclassified,1,0,1
13072,dog,spaniel,hypernymy.1,1,1,0
13071,dog,haunches,crossclassified,1,1,0
13069,school,woman,crossclassified,1,0,1
15772,clock,rail,crossclassified,1,1,0
13068,polo,woman,crossclassified,1,0,1
13067,patio,woman,crossclassified,1,0,1
13064,kitchen,salad,crossclassified,1,0,1
14929,lancet,shirt,crossclassified,1,0,1
13062,boll,house,crossclassified,1,0,1
13061,hotdog,italian,crossclassified,1,1,0
13060,grinder,hotdog,co-hyponymy,1,0,1
13059,bench,sweaters,crossclassified,1,1,0
15544,couch,pig,crossclassified,1,1,0
14930,counter,notes,crossclassified,1,1,0
13058,man,objects,hypernymy.2,1,1,0
13057,parrot,roof,crossclassified,1,0,1
13056,cabana,roof,crossclassified,1,0,1
15543,bird,finches,hypernymy.1,1,1,0
13054,roof,thatch,hypernymy.1,1,1,0
13082,rack,rail,crossclassified,1,1,0
14925,locker,oven,crossclassified,1,0,1
13084,grate,rack,co-hyponymy,1,0,1
13100,butterfly,plate,crossclassified,1,1,0
14917,blender,ire,crossclassified,1,1,0
14918,bicycler,truck,crossclassified,1,0,1
13110,dug,dugout,crossclassified,1,0,1
13109,bear,pig,crossclassified,1,1,0
13108,blanket,comforter,co-hyponymy,1,1,0
15547,person,shorts,crossclassified,1,1,0
13107,torso,truck,crossclassified,1,0,1
14919,seats,woman,crossclassified,1,0,1
13106,girl,truck,crossclassified,1,0,1
13105,plantains,pot,crossclassified,1,0,1
13103,pot,skillet,crossclassified,1,1,0
13102,pasta,pot,crossclassified,1,0,1
13101,butterfly,lemon,crossclassified,1,1,0
14920,sheet,woman,crossclassified,1,0,1
13085,child,juice,crossclassified,1,1,0
15546,child,teeth,crossclassified,1,1,0
13098,books,tent,crossclassified,1,0,1
13097,girl,tent,crossclassified,1,0,1
13096,ceiling,tent,crossclassified,1,0,1
13095,tent,trunks,crossclassified,1,1,0
13094,banana,chair,crossclassified,1,0,1
13092,building,motorbike,crossclassified,1,1,0
14921,coke,food,hypernymy.2,1,0,1
13091,dress,performer,crossclassified,1,1,0
13090,snowboard,surfboard,co-hyponymy,1,0,1
13089,kayak,surfboard,crossclassified,1,0,1
14922,bridge,pizza,crossclassified,1,1,0
14923,bridge,towers,co-hyponymy,1,1,0
15768,clock,grill,crossclassified,1,1,0
13176,face,glasses,crossclassified,1,1,0
13178,class,face,crossclassified,1,0,1
13179,bowl,grits,crossclassified,1,1,0
14860,zebra,zircon,crossclassified,1,1,0
13266,garment,kimono,hypernymy.1,1,0,1
13265,kimono,neck,crossclassified,1,1,0
13264,bodies,couch,crossclassified,1,0,1
15560,cockiness,hat,crossclassified,1,0,1
13262,girl,hood,crossclassified,1,0,1
13261,hood,lady,crossclassified,1,1,0
13258,building,condo,crossclassified,1,1,0
14863,lateen,rug,crossclassified,1,0,1
14864,bathrooms,rug,crossclassified,1,0,1
13257,airport,building,crossclassified,1,0,1
13256,bed,net,crossclassified,1,1,0
14865,boat,masts,crossclassified,1,1,0
13255,chinese,rice,crossclassified,1,0,1
13254,house,step,crossclassified,1,1,0
13253,bird,dead,crossclassified,1,1,0
14866,bar,dings,crossclassified,1,1,0
14867,suit,tied,crossclassified,1,1,0
13252,child,scoreboard,crossclassified,1,1,0
13250,horse,yawn,crossclassified,1,1,0
13249,ground,house,crossclassified,1,0,1
13248,house,steps,crossclassified,1,1,0
13247,featherbedding,shirt,crossclassified,1,0,1
13246,tub,yogurt,crossclassified,1,0,1
15763,outside,wall,crossclassified,1,0,1
13245,cup,yogurt,crossclassified,1,0,1
13241,girl,spectator,crossclassified,1,1,0
15557,baluchis,kite,crossclassified,1,0,1
15556,teed,train,crossclassified,1,0,1
14859,cow,table,crossclassified,1,1,0
14858,cap,robe,crossclassified,1,0,1
14857,outfit,robe,crossclassified,1,0,1
13280,boat,fishermen,crossclassified,1,1,0
14850,coke,shirt,crossclassified,1,0,1
13292,leotard,shirt,co-hyponymy,1,0,1
13291,car,station,crossclassified,1,1,0
13290,car,gas,crossclassified,1,1,0
13288,business,car,crossclassified,1,0,1
13287,car,interior,crossclassified,1,1,0
13286,asphalt,car,crossclassified,1,0,1
13285,apartments,house,crossclassified,1,0,1
15563,girl,spectacle,crossclassified,1,1,0
13284,curtain,telephone,crossclassified,1,1,0
13283,curtain,sweater,crossclassified,1,1,0
13282,batter,pitcher,co-hyponymy,1,1,0
13281,forearm,shirt,crossclassified,1,0,1
14852,bread,doggie,crossclassified,1,1,0
14856,phone,truck,crossclassified,1,0,1
14853,desk,pencil,crossclassified,1,1,0
13279,cabinet,track,crossclassified,1,1,0
13278,cabinet,file,crossclassified,1,1,0
13277,chateau,house,hypernymy.2,1,0,1
13276,court,horse,crossclassified,1,0,1
13275,spoon,spue,crossclassified,1,1,0
13274,highchair,jacket,crossclassified,1,1,0
13273,boy,highchair,crossclassified,1,0,1
15761,tree,wall,crossclassified,1,0,1
14854,house,watch,crossclassified,1,1,0
15562,bradstreet,couch,crossclassified,1,0,1
13271,cheetah,jaguar,co-hyponymy,1,1,0
14855,house,statue,crossclassified,1,1,0
13239,cake,torte,hypernymy.1,1,1,0
14869,couch,mouse,crossclassified,1,1,0
13238,player,shorts,crossclassified,1,1,0
14880,clock,footstool,crossclassified,1,1,0
13203,bridge,scoreboard,crossclassified,1,1,0
15553,bird,gator,crossclassified,1,1,0
13200,ca,dugout,crossclassified,1,0,1
13199,cow,gazelle,crossclassified,1,1,0
13198,cow,zebu,crossclassified,1,1,0
13197,antelope,cow,crossclassified,1,0,1
15765,man,snacks,crossclassified,1,1,0
13196,dog,umpire,crossclassified,1,1,0
14878,carpet,clock,crossclassified,1,0,1
13194,man,mover,crossclassified,1,1,0
13193,bowl,tangerine,crossclassified,1,1,0
14879,clock,pillow,crossclassified,1,1,0
13191,cat,clothes,crossclassified,1,1,0
14882,fruits,jacket,crossclassified,1,0,1
13205,flier,man,co-hyponymy,1,0,1
13189,chair,sand,crossclassified,1,1,0
14883,jacket,manana,crossclassified,1,1,0
14885,liquid,strawberry,crossclassified,1,0,1
13188,automobile,building,crossclassified,1,0,1
13187,car,ut,crossclassified,1,1,0
13186,paw,table,crossclassified,1,0,1
13185,wheelchair,woman,crossclassified,1,0,1
14886,bed,fort,crossclassified,1,1,0
14887,chair,foods,crossclassified,1,1,0
15552,boy,jeans,crossclassified,1,1,0
13183,floor,house,crossclassified,1,0,1
14888,pizza,shrimp,crossclassified,1,1,0
14890,elephant,headpiece,crossclassified,1,1,0
13204,daughter,shirt,crossclassified,1,0,1
13206,motorcycle,transporter,crossclassified,1,1,0
13237,shower,washbasin,crossclassified,1,1,0
13221,face,zebra,crossclassified,1,0,1
13236,handstand,skater,crossclassified,1,0,1
15764,boat,recycling,crossclassified,1,1,0
13235,amphora,vase,co-hyponymy,1,0,1
13232,plane,tarmac,crossclassified,1,1,0
13231,plane,ramp,crossclassified,1,1,0
13230,man,passengers,crossclassified,1,1,0
14871,foods,jacket,crossclassified,1,0,1
13228,rebel,woman,crossclassified,1,0,1
13227,businesswoman,shirt,crossclassified,1,0,1
13226,drapes,statue,crossclassified,1,0,1
13223,harpooner,man,co-hyponymy,1,0,1
13222,man,phones,crossclassified,1,1,0
15555,counter,ingredients,crossclassified,1,1,0
13220,child,clothes,crossclassified,1,1,0
13207,truck,worker,crossclassified,1,1,0
14872,ballplayer,player,hypernymy.2,1,0,1
13219,doll,teapot,crossclassified,1,0,1
13216,coffeepot,teapot,co-hyponymy,1,0,1
13215,container,teapot,hypernymy.1,1,0,1
13214,res,woman,crossclassified,1,0,1
13213,scorch,shirt,crossclassified,1,0,1
13212,man,tall,crossclassified,1,1,0
13211,blouse,kimono,crossclassified,1,0,1
14873,player,playing,crossclassified,1,1,0
13210,kimono,phone,crossclassified,1,1,0
15554,counter,mushroom,crossclassified,1,1,0
13209,hands,kimono,crossclassified,1,0,1
13208,cellphone,kimono,crossclassified,1,0,1
15368,police,truck,crossclassified,1,0,1
7912,honorifics,vase,crossclassified,1,0,1
11337,cycle,horse,crossclassified,1,0,1
5612,blender,glassware,crossclassified,1,1,0
5598,convertibility,grill,crossclassified,1,0,1
5599,grill,machine,crossclassified,1,1,0
5600,grill,toaster,crossclassified,1,1,0
5604,bench,mushroom,crossclassified,1,1,0
5606,base,bench,crossclassified,1,0,1
5607,bench,structure,crossclassified,1,1,0
5614,bed,black,crossclassified,1,1,0
5591,curtain,flowers,crossclassified,1,1,0
5617,boa,woman,crossclassified,1,0,1
5619,dress,teddy,crossclassified,1,1,0
5622,commuter,woman,crossclassified,1,0,1
5623,counter,pots,crossclassified,1,1,0
5625,bottle,snack,crossclassified,1,1,0
5626,bottle,seasoning,crossclassified,1,1,0
5596,grid,grill,crossclassified,1,0,1
5590,curtain,tree,crossclassified,1,1,0
6066,horse,mustang,hypernymy.1,1,1,0
5565,cat,jug,crossclassified,1,1,0
5540,man,senior,co-hyponymy,1,1,0
5542,bread,rice,co-hyponymy,1,0,1
5551,bagel,snacks,crossclassified,1,1,0
5555,pie,snack,crossclassified,1,1,0
5557,knife,pie,crossclassified,1,0,1
5564,horse,mane,crossclassified,1,1,0
5568,chapati,counter,crossclassified,1,0,1
5584,jacket,recorder,crossclassified,1,1,0
5569,counter,dinner,crossclassified,1,1,0
5570,cheese,knife,crossclassified,1,0,1
5571,knife,snacks,crossclassified,1,1,0
5574,knife,tomatoes,crossclassified,1,1,0
5576,boy,zip,crossclassified,1,1,0
5583,child,snacks,crossclassified,1,1,0
5628,dewy,shirt,crossclassified,1,0,1
5629,dog,stone,crossclassified,1,1,0
5633,family,giraffe,crossclassified,1,0,1
5694,parrot,toucan,crossclassified,1,1,0
5679,book,paper,co-hyponymy,1,1,0
5683,sheep,sticks,crossclassified,1,1,0
5684,decoration,sheep,crossclassified,1,0,1
5685,sheep,stone,crossclassified,1,1,0
5687,cat,ribbon,crossclassified,1,1,0
5693,bottom,vase,crossclassified,1,0,1
5695,airplane,giraffe,crossclassified,1,0,1
5639,referee,umpire,co-hyponymy,1,0,1
5698,skier,surfer,crossclassified,1,1,0
5701,bed,knee,crossclassified,1,1,0
5702,dress,rope,crossclassified,1,1,0
5703,boat,net,crossclassified,1,1,0
5705,building,duplex,hypernymy.1,1,1,0
5706,airplane,shuttle,crossclassified,1,1,0
5677,cow,handbag,crossclassified,1,1,0
5674,counter,zing,crossclassified,1,1,0
5673,counter,wassermann,crossclassified,1,1,0
5672,jacket,rope,crossclassified,1,1,0
5671,bowl,packets,crossclassified,1,1,0
5670,bowl,trash,crossclassified,1,1,0
5667,child,paper,crossclassified,1,1,0
5665,giraffe,table,crossclassified,1,1,0
5663,cake,teddy,crossclassified,1,1,0
5661,bird,starling,hypernymy.1,1,1,0
5653,racquet,shirt,crossclassified,1,0,1
5652,glove,man,crossclassified,1,0,1
5647,dog,furniture,crossclassified,1,1,0
5646,dog,handbag,crossclassified,1,1,0
5643,horse,racing,crossclassified,1,1,0
5642,engine,hood,crossclassified,1,0,1
5641,hood,snow,crossclassified,1,1,0
5539,man,octogenarian,crossclassified,1,1,0
5530,building,storefronts,crossclassified,1,1,0
5529,nerd,shirt,crossclassified,1,0,1
5427,bull,saddle,crossclassified,1,1,0
5408,animal,food,crossclassified,1,0,1
5409,grill,pork,crossclassified,1,1,0
5412,barque,sandwich,crossclassified,1,0,1
5415,entrance,house,crossclassified,1,0,1
5422,airplane,propellor,crossclassified,1,1,0
5423,fire,shirt,crossclassified,1,0,1
5429,bikers,bridge,crossclassified,1,0,1
5445,jewelry,shirt,crossclassified,1,0,1
5431,bridge,motorcyclist,crossclassified,1,1,0
5432,bridge,motorcycles,crossclassified,1,1,0
5433,grass,jacket,crossclassified,1,0,1
5435,licentiate,truck,crossclassified,1,0,1
5440,curtains,table,crossclassified,1,0,1
5442,jacket,smile,crossclassified,1,1,0
5407,food,sub,hypernymy.1,1,1,0
5404,truck,wheelbarrow,co-hyponymy,1,1,0
5403,bus,house,crossclassified,1,0,1
5400,bowl,coaster,crossclassified,1,1,0
5399,bowl,light,crossclassified,1,1,0
5398,bowl,decoration,crossclassified,1,1,0
5397,brochette,food,crossclassified,1,0,1
5396,food,margarita,hypernymy.1,1,1,0
5394,cracker,food,hypernymy.2,1,0,1
5392,cheerer,curtain,crossclassified,1,0,1
5388,cookie,cracker,crossclassified,1,1,0
5386,lens,person,crossclassified,1,0,1
5382,stripper,woman,crossclassified,1,0,1
5380,woman,yogi,crossclassified,1,1,0
5378,carpet,group,crossclassified,1,1,0
5371,nightshirts,shirt,crossclassified,1,0,1
5369,hat,kid,crossclassified,1,1,0
5444,avocado,sandwich,crossclassified,1,0,1
5446,butterfly,wing,crossclassified,1,1,0
5519,celery,lettuce,co-hyponymy,1,0,1
5503,jacket,snakes,crossclassified,1,1,0
5497,cement,platform,crossclassified,1,0,1
5498,dock,platform,hypernymy.2,1,0,1
5499,concrete,platform,crossclassified,1,0,1
5500,floor,platform,co-hyponymy,1,0,1
5501,bed,bread,crossclassified,1,1,0
5502,cu,jacket,crossclassified,1,0,1
5504,mug,pot,co-hyponymy,1,0,1
5448,bench,specs,crossclassified,1,1,0
5505,pot,veggies,crossclassified,1,1,0
5506,entertainer,man,co-hyponymy,1,0,1
5510,apple,insect,crossclassified,1,1,0
5512,man,windbreaker,crossclassified,1,1,0
5514,train,traitorousness,crossclassified,1,1,0
5517,jacket,visor,crossclassified,1,1,0
5495,platform,station,crossclassified,1,1,0
5494,ground,platform,crossclassified,1,0,1
5493,platform,walkway,crossclassified,1,1,0
5488,cake,mm,crossclassified,1,1,0
5482,boy,moose,crossclassified,1,1,0
5477,beer,liquid,hypernymy.2,1,1,0
5473,keyboard,ledge,crossclassified,1,1,0
5469,airplane,arm,crossclassified,1,1,0
5466,cap,desk,crossclassified,1,0,1
5463,desk,scissors,crossclassified,1,1,0
5462,beads,shirt,crossclassified,1,0,1
5460,car,girl,crossclassified,1,0,1
5457,dog,rider,crossclassified,1,1,0
5456,cat,phone,crossclassified,1,1,0
5454,bottle,toy,crossclassified,1,1,0
5450,donut,entree,crossclassified,1,1,0
5449,dish,donut,crossclassified,1,0,1
5709,hat,surfer,crossclassified,1,0,1
5711,helmet,surfer,crossclassified,1,0,1
5713,browser,surfer,crossclassified,1,0,1
5952,grill,tower,crossclassified,1,0,1
5941,couch,pot,crossclassified,1,1,0
5947,garage,overhang,crossclassified,1,1,0
5948,garage,hanger,crossclassified,1,1,0
5949,garage,warehouse,crossclassified,1,1,0
5950,garage,shed,co-hyponymy,1,1,0
5951,depot,garage,crossclassified,1,0,1
5953,house,tower,crossclassified,1,0,1
5976,container,juice,crossclassified,1,0,1
5956,pole,tower,crossclassified,1,0,1
5958,daffodil,flower,crossclassified,1,0,1
5963,cake,cloth,crossclassified,1,1,0
5964,overhang,tent,crossclassified,1,0,1
5965,stage,tent,crossclassified,1,0,1
5968,bulgur,table,crossclassified,1,0,1
5935,bathtub,drill,crossclassified,1,1,0
5931,bench,dais,crossclassified,1,1,0
5928,machine,microwave,crossclassified,1,0,1
5925,die,jacket,crossclassified,1,0,1
5923,container,sandwich,crossclassified,1,0,1
5919,carriage,coach,synonymy,1,1,0
5915,carriage,rope,crossclassified,1,1,0
5914,fur,table,crossclassified,1,0,1
5913,table,tube,crossclassified,1,1,0
5911,glass,snowboarder,crossclassified,1,0,1
5909,bowl,chantey,crossclassified,1,1,0
5908,doge,goat,crossclassified,1,0,1
5906,hood,tent,crossclassified,1,1,0
5903,cup,milkshake,crossclassified,1,1,0
5902,cup,snacks,crossclassified,1,1,0
5901,dogs,goat,crossclassified,1,0,1
5900,mantle,marble,crossclassified,1,1,0
5969,giraffe,juvenile,crossclassified,1,1,0
5978,jug,juice,crossclassified,1,0,1
5898,clock,mantle,crossclassified,1,0,1
6044,butter,cake,crossclassified,1,0,1
6026,boat,trees,crossclassified,1,1,0
6027,boat,indonesian,crossclassified,1,1,0
6030,snacks,turkey,crossclassified,1,0,1
6034,fire,jet,crossclassified,1,0,1
6037,berry,bowl,crossclassified,1,0,1
6041,slippers,table,crossclassified,1,0,1
6047,design,horse,crossclassified,1,0,1
5979,juice,vegetable,crossclassified,1,1,0
6048,costume,horse,crossclassified,1,0,1
6051,catcher,child,crossclassified,1,1,0
6055,cot,curtain,crossclassified,1,0,1
6057,man,utensils,crossclassified,1,1,0
6058,branch,giraffe,crossclassified,1,0,1
6060,housing,tree,crossclassified,1,0,1
6023,scaffolding,tent,crossclassified,1,0,1
6016,court,person,crossclassified,1,1,0
6015,athlete,court,crossclassified,1,0,1
6014,bat,court,crossclassified,1,0,1
6012,dude,shirt,crossclassified,1,0,1
6011,ice,man,crossclassified,1,0,1
6009,pizza,utensil,crossclassified,1,1,0
6008,jacket,kimberlite,crossclassified,1,1,0
6007,dress,maxi,crossclassified,1,1,0
6006,horse,racehorses,hypernymy.1,1,1,0
6001,shirt,stick,crossclassified,1,1,0
5999,car,couple,crossclassified,1,1,0
5998,car,riders,crossclassified,1,1,0
5994,sandwich,subway,crossclassified,1,1,0
5993,bowl,mouse,crossclassified,1,0,1
5981,juice,powder,crossclassified,1,1,0
5980,fruit,juice,crossclassified,1,0,1
5899,banister,mantle,crossclassified,1,0,1
5896,mantle,stool,crossclassified,1,1,0
5716,outfit,suit,crossclassified,1,0,1
5794,teddy,woman,crossclassified,1,0,1
5778,cotton,rice,crossclassified,1,0,1
5780,fighter,jet,co-hyponymy,1,0,1
5781,archer,horse,crossclassified,1,0,1
5782,lamp,truck,crossclassified,1,0,1
5790,sheet,tent,crossclassified,1,0,1
5792,cat,teddy,crossclassified,1,1,0
5795,shaver,woman,crossclassified,1,0,1
5813,altar,tent,crossclassified,1,0,1
5796,sheep,woman,crossclassified,1,0,1
5800,chair,hat,crossclassified,1,0,1
5803,board,dress,crossclassified,1,0,1
5805,bird,plant,crossclassified,1,1,0
5807,ribbon,tent,crossclassified,1,0,1
5811,hoop,tent,crossclassified,1,0,1
5777,dessert,rice,crossclassified,1,0,1
5772,cat,zing,crossclassified,1,1,0
5756,game,man,co-hyponymy,1,0,1
5755,building,plane,crossclassified,1,1,0
5754,building,wing,crossclassified,1,1,0
5753,building,museum,crossclassified,1,1,0
5746,piece,pizza,crossclassified,1,0,1
5740,avocado,knife,crossclassified,1,0,1
5739,knife,strawberry,crossclassified,1,1,0
5738,shapes,soup,crossclassified,1,0,1
5737,broth,soup,hypernymy.2,1,0,1
5733,door,plane,crossclassified,1,0,1
5726,trainer,woman,crossclassified,1,0,1
5724,guard,woman,crossclassified,1,0,1
5723,officer,woman,crossclassified,1,0,1
5722,giraffe,zebras,crossclassified,1,1,0
5718,books,rug,crossclassified,1,0,1
5812,arch,tent,crossclassified,1,0,1
5814,archway,tent,crossclassified,1,0,1
5895,decor,mantle,crossclassified,1,0,1
5877,carpet,toilet,crossclassified,1,1,0
5861,light,scooter,crossclassified,1,0,1
5865,hat,rug,crossclassified,1,1,0
5867,dog,net,crossclassified,1,1,0
5871,book,lamp,crossclassified,1,0,1
5872,file,lamp,crossclassified,1,0,1
5873,drawers,lamp,crossclassified,1,0,1
5880,man,racer,crossclassified,1,1,0
5816,flower,tent,crossclassified,1,0,1
5881,cake,cap,crossclassified,1,1,0
5882,batter,sportsman,crossclassified,1,1,0
5886,horse,strap,crossclassified,1,1,0
5890,hurler,man,crossclassified,1,0,1
5892,ledge,mantle,crossclassified,1,0,1
5893,fireplace,mantle,crossclassified,1,0,1
5859,boxes,table,crossclassified,1,0,1
5854,bookshop,carpet,crossclassified,1,0,1
5853,bookable,carpet,crossclassified,1,0,1
5850,bridge,counter,crossclassified,1,0,1
5846,electronics,television,crossclassified,1,0,1
5845,television,tv,synonymy,1,1,0
5844,laptop,television,crossclassified,1,0,1
5843,television,wooden,crossclassified,1,1,0
5841,metacenter,television,crossclassified,1,0,1
5840,console,television,crossclassified,1,0,1
5839,furniture,television,crossclassified,1,0,1
5835,airplane,front,crossclassified,1,1,0
5834,tie,train,crossclassified,1,0,1
5833,dog,head,co-hyponymy,1,1,0
5830,cloth,hat,crossclassified,1,0,1
5822,fruit,sandwich,crossclassified,1,0,1
5817,court,tent,crossclassified,1,0,1
5367,girl,purse,crossclassified,1,1,0
5364,bridge,elephant,crossclassified,1,1,0
5363,bridge,promenade,crossclassified,1,1,0
4885,lava,sandwich,crossclassified,1,0,1
4871,cat,horse,crossclassified,1,0,1
4874,pillar,pole,crossclassified,1,0,1
4875,board,pole,crossclassified,1,0,1
4877,ballplayer,batter,hypernymy.1,1,0,1
4882,casserole,table,crossclassified,1,0,1
4884,sandwich,spread,crossclassified,1,1,0
4887,man,poser,crossclassified,1,1,0
4906,animal,mammal,hypernymy.1,1,1,0
4891,desk,napkin,crossclassified,1,1,0
4893,man,pads,crossclassified,1,1,0
4895,sandwich,waffle,crossclassified,1,1,0
4897,jaw,shirt,crossclassified,1,0,1
4898,skater,sportsman,co-hyponymy,1,1,0
4902,animal,steer,hypernymy.1,1,1,0
4870,carrot,horse,crossclassified,1,0,1
4869,curtain,remotes,crossclassified,1,1,0
4867,curtain,electronics,crossclassified,1,1,0
4866,curtain,game,crossclassified,1,1,0
4864,motorcycle,shrub,crossclassified,1,1,0
4859,holder,jar,crossclassified,1,0,1
4858,jar,pot,co-hyponymy,1,1,0
4857,jar,spoon,co-hyponymy,1,1,0
4851,kite,model,crossclassified,1,1,0
4850,kite,sky,crossclassified,1,1,0
4849,aircraft,kite,crossclassified,1,0,1
4846,man,runway,crossclassified,1,0,1
4845,people,runway,crossclassified,1,0,1
4843,barrier,runway,crossclassified,1,0,1
4838,raceway,runway,crossclassified,1,0,1
4837,runway,spectators,crossclassified,1,1,0
4835,ascot,shirt,crossclassified,1,0,1
4905,animal,gnu,crossclassified,1,1,0
4908,barrel,boat,crossclassified,1,0,1
4831,shillelagh,squirrel,crossclassified,1,0,1
4985,ponytail,woman,crossclassified,1,0,1
4965,bucket,waste,crossclassified,1,1,0
4966,salad,tacos,co-hyponymy,1,1,0
4970,helper,man,hypernymy.1,1,0,1
4971,mobile,train,crossclassified,1,0,1
4972,phone,train,crossclassified,1,0,1
4975,juggler,woman,crossclassified,1,0,1
4990,clothing,house,crossclassified,1,0,1
4912,broccoli,veggies,hypernymy.2,1,1,0
4997,pizza,pork,crossclassified,1,1,0
4998,grapes,table,crossclassified,1,0,1
5000,boat,steamship,crossclassified,1,1,0
5001,brush,sheep,crossclassified,1,0,1
5003,napkins,sink,crossclassified,1,0,1
5004,desk,sink,crossclassified,1,0,1
4964,bucket,knife,crossclassified,1,1,0
4963,basket,bucket,co-hyponymy,1,0,1
4956,bed,food,crossclassified,1,1,0
4954,paper,queen,hypernymy.1,1,0,1
4952,drawing,queen,crossclassified,1,0,1
4949,jacket,necktie,crossclassified,1,1,0
4947,train,tussle,crossclassified,1,1,0
4946,hairdresser,shirt,crossclassified,1,0,1
4942,can,din,crossclassified,1,1,0
4934,curtain,radio,crossclassified,1,1,0
4932,bib,child,crossclassified,1,0,1
4930,airplane,thruster,crossclassified,1,1,0
4927,boy,eat,crossclassified,1,1,0
4923,grill,skier,crossclassified,1,0,1
4922,americanizations,bridge,crossclassified,1,0,1
4917,bench,bleacher,crossclassified,1,1,0
4913,broccoli,leaf,crossclassified,1,1,0
4834,elder,woman,co-hyponymy,1,0,1
4830,squarish,squirrel,crossclassified,1,0,1
5007,glove,snowboarder,crossclassified,1,0,1
4717,ear,woman,crossclassified,1,0,1
4697,carpet,light,crossclassified,1,1,0
4706,bottle,hamster,crossclassified,1,0,1
4708,man,phon,crossclassified,1,1,0
4710,house,parallax,crossclassified,1,1,0
4712,bun,giraffe,crossclassified,1,1,0
4713,bun,slice,crossclassified,1,1,0
4718,ace,cow,crossclassified,1,0,1
4747,bawl,train,crossclassified,1,0,1
4724,street,woman,crossclassified,1,1,0
4727,backpack,street,crossclassified,1,0,1
4728,cobblestone,street,crossclassified,1,0,1
4732,boat,serial,crossclassified,1,1,0
4733,smock,woman,crossclassified,1,0,1
4734,dugout,shed,crossclassified,1,1,0
4695,bird,figure,crossclassified,1,1,0
4694,bird,decoration,crossclassified,1,1,0
4692,crumpet,pancake,co-hyponymy,1,0,1
4687,platform,runway,hypernymy.1,1,0,1
4679,boy,hungry,crossclassified,1,1,0
4674,cake,desk,crossclassified,1,0,1
4672,broccoli,plant,hypernymy.2,1,1,0
4671,broccoli,lower,crossclassified,1,1,0
4663,beanie,man,crossclassified,1,0,1
4654,bowl,roast,crossclassified,1,1,0
4653,para,sandwich,crossclassified,1,0,1
4652,piece,sandwich,crossclassified,1,0,1
4647,chair,microphone,crossclassified,1,1,0
4645,gyro,pizza,crossclassified,1,0,1
4643,handsaws,sink,crossclassified,1,0,1
4640,relaxer,woman,crossclassified,1,0,1
4637,dog,skating,crossclassified,1,1,0
4737,child,dugout,crossclassified,1,0,1
4750,chef,tray,crossclassified,1,0,1
4827,goalie,soccer,crossclassified,1,1,0
4810,booth,candle,crossclassified,1,1,0
4792,car,shorts,crossclassified,1,1,0
4798,airplane,dude,crossclassified,1,1,0
4801,friend,girl,crossclassified,1,0,1
4802,hood,lid,co-hyponymy,1,1,0
4804,carrot,cat,crossclassified,1,0,1
4809,listening,man,crossclassified,1,0,1
4814,fishwife,woman,crossclassified,1,0,1
4752,pastry,tray,crossclassified,1,0,1
4816,knife,rode,crossclassified,1,1,0
4819,goalie,kid,crossclassified,1,1,0
4823,goalie,jersey,crossclassified,1,1,0
4824,child,goalie,crossclassified,1,0,1
4825,goalie,helmet,crossclassified,1,1,0
4826,goalie,keeper,crossclassified,1,1,0
4790,ant,boy,crossclassified,1,0,1
4789,brick,cake,crossclassified,1,0,1
4788,cake,foam,crossclassified,1,1,0
4787,backpack,cat,crossclassified,1,0,1
4783,ostrich,tree,crossclassified,1,1,0
4781,boy,lancet,crossclassified,1,1,0
4780,hotdog,puffs,crossclassified,1,1,0
4779,hotdog,sloppy,crossclassified,1,1,0
4774,mixer,truck,crossclassified,1,0,1
4771,man,picture,crossclassified,1,1,0
4770,man,stand,crossclassified,1,1,0
4769,frame,man,crossclassified,1,0,1
4768,bathrooms,bathtub,crossclassified,1,0,1
4765,camel,horse,crossclassified,1,0,1
4763,bread,steak,crossclassified,1,1,0
4754,sweet,tray,crossclassified,1,0,1
4753,glass,tray,crossclassified,1,0,1
5005,bar,sink,crossclassified,1,0,1
5016,buffet,stove,crossclassified,1,0,1
5362,animals,bridge,crossclassified,1,0,1
5249,balcony,table,crossclassified,1,0,1
5239,phones,woman,crossclassified,1,0,1
5240,restaurant,woman,crossclassified,1,0,1
5243,electrification,train,crossclassified,1,0,1
5246,decolletage,shirt,crossclassified,1,0,1
5247,ski,train,crossclassified,1,0,1
5248,snowboard,train,crossclassified,1,0,1
5253,bucket,food,crossclassified,1,1,0
5276,solider,woman,crossclassified,1,0,1
5262,car,crowd,crossclassified,1,1,0
5263,cleat,woman,crossclassified,1,0,1
5267,girl,shear,crossclassified,1,1,0
5270,donut,hotdog,crossclassified,1,1,0
5271,person,worker,hypernymy.1,1,1,0
5272,belt,person,crossclassified,1,0,1
5238,car,pipe,crossclassified,1,1,0
5236,african,man,co-hyponymy,1,0,1
5235,attire,man,crossclassified,1,0,1
5234,snakes,woman,crossclassified,1,0,1
5230,bagel,muffin,crossclassified,1,1,0
5224,boy,trunk,crossclassified,1,1,0
5222,coat,teddy,crossclassified,1,1,0
5219,clothing,counter,crossclassified,1,0,1
5218,counter,toy,crossclassified,1,1,0
5213,paper,person,crossclassified,1,0,1
5212,bread,person,crossclassified,1,0,1
5210,crib,mat,crossclassified,1,1,0
5209,cradle,crib,co-hyponymy,1,0,1
5208,crib,steel,crossclassified,1,1,0
5206,dog,donut,crossclassified,1,1,0
5205,dugout,grunt,crossclassified,1,1,0
5203,squash,veg,hypernymy.2,1,1,0
5275,floor,naval,crossclassified,1,1,0
5280,osprey,plane,crossclassified,1,0,1
5201,produce,squash,hypernymy.1,1,0,1
5348,flower,zinnia,hypernymy.1,1,1,0
5335,bathtub,possum,crossclassified,1,1,0
5337,corset,woman,crossclassified,1,0,1
5339,dish,vase,crossclassified,1,0,1
5340,centerpiece,vase,crossclassified,1,0,1
5341,girl,paste,crossclassified,1,1,0
5345,airplane,rug,crossclassified,1,0,1
5349,foot,pizza,crossclassified,1,0,1
5281,bird,lorikeet,hypernymy.1,1,1,0
5351,airplane,mountains,crossclassified,1,1,0
5352,house,leafs,crossclassified,1,1,0
5354,stein,vase,crossclassified,1,0,1
5357,chair,juke,crossclassified,1,1,0
5360,badge,shirt,crossclassified,1,0,1
5361,control,shirt,crossclassified,1,0,1
5330,cupcake,sweet,crossclassified,1,1,0
5325,stature,woman,crossclassified,1,0,1
5316,diesel,truck,crossclassified,1,0,1
5314,dress,sea,crossclassified,1,1,0
5313,bed,hospital,crossclassified,1,1,0
5310,hat,mascot,crossclassified,1,1,0
5306,food,objects,co-hyponymy,1,1,0
5305,food,sandwiches,hypernymy.1,1,1,0
5304,appetizers,food,hypernymy.2,1,0,1
5302,dressing,shirt,crossclassified,1,0,1
5300,shirt,trumpet,crossclassified,1,1,0
5299,horn,horse,crossclassified,1,0,1
5298,badge,jacket,crossclassified,1,0,1
5292,nachos,pizza,crossclassified,1,0,1
5291,brushing,man,crossclassified,1,0,1
5288,chair,gown,crossclassified,1,1,0
5282,skater,zebu,crossclassified,1,1,0
5202,bowl,squash,crossclassified,1,0,1
5196,desk,jacket,crossclassified,1,0,1
5019,stove,tin,crossclassified,1,1,0
5090,bride,car,crossclassified,1,0,1
5070,desk,diary,crossclassified,1,1,0
5073,house,lady,crossclassified,1,1,0
5077,cherries,jar,crossclassified,1,0,1
5078,jar,jelly,crossclassified,1,1,0
5083,food,fruits,crossclassified,1,1,0
5084,house,windows,crossclassified,1,1,0
5096,fruit,stall,crossclassified,1,1,0
5111,bridge,war,crossclassified,1,1,0
5097,fruit,market,crossclassified,1,1,0
5098,bowl,child,crossclassified,1,0,1
5100,child,pot,crossclassified,1,1,0
5101,fresh,shirt,crossclassified,1,0,1
5106,overcoat,woman,crossclassified,1,0,1
5109,greens,plate,crossclassified,1,0,1
5066,burglar,salad,crossclassified,1,0,1
5062,girl,mannequin,crossclassified,1,1,0
5061,class,girl,crossclassified,1,0,1
5059,dinner,woman,crossclassified,1,0,1
5057,man,tag,crossclassified,1,1,0
5055,beach,stick,crossclassified,1,1,0
5054,beach,water,crossclassified,1,1,0
5052,beach,furniture,crossclassified,1,1,0
5049,beach,street,crossclassified,1,1,0
5045,artwork,beach,crossclassified,1,0,1
5040,brushing,girl,crossclassified,1,0,1
5037,curtain,hanging,crossclassified,1,1,0
5032,strings,tie,hypernymy.2,1,0,1
5030,circuit,tie,crossclassified,1,0,1
5029,sewing,tie,crossclassified,1,0,1
5027,put,toilet,crossclassified,1,0,1
5022,brushing,woman,crossclassified,1,0,1
5110,plate,squash,crossclassified,1,1,0
5112,bridge,flag,crossclassified,1,1,0
5195,jacket,workspace,crossclassified,1,1,0
5177,pancake,strawberry,crossclassified,1,1,0
5168,pan,sheet,crossclassified,1,1,0
5170,metal,pan,crossclassified,1,0,1
5172,chair,raft,crossclassified,1,1,0
5173,chair,sunglass,crossclassified,1,1,0
5175,christmastime,jacket,crossclassified,1,0,1
5176,fork,pancake,crossclassified,1,0,1
5178,dessert,pancake,crossclassified,1,0,1
5113,bridge,port,crossclassified,1,1,0
5180,bridge,grass,crossclassified,1,1,0
5183,fingers,woman,crossclassified,1,0,1
5184,hill,zebra,crossclassified,1,0,1
5189,foot,hamster,crossclassified,1,0,1
5190,boy,necktie,crossclassified,1,1,0
5191,cigarette,man,crossclassified,1,0,1
5166,bangles,woman,crossclassified,1,0,1
5164,auto,mirror,crossclassified,1,0,1
5160,building,shears,crossclassified,1,1,0
5159,food,tomatoes,hypernymy.1,1,1,0
5156,bookshelf,stand,crossclassified,1,1,0
5151,shirt,wisconsinite,crossclassified,1,1,0
5148,cabinet,clothes,crossclassified,1,1,0
5144,port,ship,crossclassified,1,0,1
5137,bread,sweet,crossclassified,1,1,0
5135,hotdogs,man,crossclassified,1,0,1
5126,boarder,surfer,crossclassified,1,0,1
5125,station,table,crossclassified,1,0,1
5124,green,table,crossclassified,1,0,1
5121,beans,sandwich,crossclassified,1,0,1
5120,lutenist,man,crossclassified,1,0,1
5118,giraffe,sheep,crossclassified,1,0,1
5115,hat,truck,crossclassified,1,0,1
6063,cake,plat,crossclassified,1,1,0
6068,dress,seedless,crossclassified,1,1,0
4631,curtain,washroom,crossclassified,1,1,0
6858,glider,man,crossclassified,1,1,0
6849,napkin,vest,co-hyponymy,1,0,1
6851,towel,vest,crossclassified,1,0,1
6852,floor,skater,crossclassified,1,0,1
6854,pan,utensil,hypernymy.2,1,1,0
6855,shirt,sportswear,crossclassified,1,1,0
6856,couch,sear,crossclassified,1,1,0
6860,aircraft,glider,hypernymy.1,1,0,1
6847,man,muffler,crossclassified,1,1,0
6863,meal,pancake,crossclassified,1,0,1
6864,ladder,plane,co-hyponymy,1,0,1
6865,car,sash,crossclassified,1,1,0
6866,car,winner,crossclassified,1,1,0
6867,car,crown,crossclassified,1,1,0
6869,flatbread,food,hypernymy.2,1,0,1
6848,chair,vest,crossclassified,1,0,1
6843,pizza,sausage,crossclassified,1,1,0
6072,bottle,flower,crossclassified,1,0,1
6829,toga,tunic,co-hyponymy,1,1,0
6823,toga,wrap,co-hyponymy,1,1,0
6824,toga,towel,crossclassified,1,1,0
6825,outfit,toga,crossclassified,1,0,1
6826,man,toga,crossclassified,1,0,1
6827,sheet,toga,crossclassified,1,0,1
6828,dress,toga,crossclassified,1,0,1
6830,t-shirt,toga,crossclassified,1,0,1
6842,player,running,crossclassified,1,1,0
6831,man,priest,crossclassified,1,1,0
6832,doctor,man,crossclassified,1,0,1
6835,building,columns,co-hyponymy,1,1,0
6837,building,homes,crossclassified,1,1,0
6839,rug,television,crossclassified,1,1,0
6840,rug,wall,crossclassified,1,1,0
6870,hut,pole,crossclassified,1,1,0
6873,hut,villa,crossclassified,1,1,0
6874,headband,man,crossclassified,1,0,1
6924,cooking,pizza,crossclassified,1,0,1
6918,bread,mustard,crossclassified,1,0,1
6919,mustard,snakes,crossclassified,1,1,0
6920,mustard,sausage,crossclassified,1,1,0
6921,electronics,plane,crossclassified,1,0,1
6922,beefburger,sandwich,hypernymy.2,1,0,1
6923,man,unmannerly,crossclassified,1,1,0
6925,doorway,woman,crossclassified,1,0,1
6875,neoprene,zebra,crossclassified,1,0,1
6926,boy,schoolboy,hypernymy.1,1,1,0
6928,pants,sheep,crossclassified,1,0,1
6929,hat,trilby,hypernymy.1,1,1,0
6933,bridge,garage,crossclassified,1,1,0
6934,bridge,skywalk,crossclassified,1,1,0
6935,bridge,sticker,crossclassified,1,1,0
6917,pitcher,sportsman,crossclassified,1,1,0
6916,birds,jacket,crossclassified,1,0,1
6914,pastry,plate,crossclassified,1,0,1
6911,giraffe,trough,crossclassified,1,1,0
6910,cheetah,lion,co-hyponymy,1,0,1
6909,leopard,lion,co-hyponymy,1,0,1
6908,grass,lion,crossclassified,1,0,1
6907,dog,lion,crossclassified,1,0,1
6902,glove,palm,crossclassified,1,1,0
6899,glove,tie,crossclassified,1,1,0
6898,cloth,glove,crossclassified,1,0,1
6895,plaid,skateboarder,crossclassified,1,0,1
6894,guardhouse,house,crossclassified,1,0,1
6893,house,warehousemen,crossclassified,1,1,0
6892,checkpoint,house,crossclassified,1,0,1
6886,desk,windowsill,crossclassified,1,1,0
6883,building,wire,crossclassified,1,1,0
6820,house,rod,crossclassified,1,1,0
6817,diner,girl,crossclassified,1,0,1
6816,chair,cow,crossclassified,1,0,1
6740,player,scoreboard,crossclassified,1,0,1
6727,condiments,hotdogs,crossclassified,1,0,1
6728,hotdogs,pizza,crossclassified,1,1,0
6729,burger,hotdogs,co-hyponymy,1,0,1
6732,man,plates,crossclassified,1,1,0
6733,billboard,scoreboard,co-hyponymy,1,0,1
6737,jersey,scoreboard,crossclassified,1,0,1
6742,scoreboard,screen,crossclassified,1,1,0
6754,ham,turkey,crossclassified,1,0,1
6743,scoreboard,timer,crossclassified,1,1,0
6746,wedding,woman,crossclassified,1,0,1
6747,damsel,woman,hypernymy.2,1,0,1
6748,bedpost,curtain,crossclassified,1,0,1
6749,curtain,headboard,crossclassified,1,1,0
6752,dog,wheelchair,crossclassified,1,0,1
6725,patch,woman,crossclassified,1,0,1
6724,cross,woman,crossclassified,1,0,1
6719,almonds,girl,crossclassified,1,0,1
6718,brush,bucket,crossclassified,1,0,1
6717,bucket,tub,co-hyponymy,1,1,0
6716,note,table,crossclassified,1,0,1
6712,desk,feet,crossclassified,1,1,0
6707,floor,jar,crossclassified,1,1,0
6706,floor,fridge,crossclassified,1,1,0
6705,floor,refrigerator,crossclassified,1,1,0
6702,shelf,vent,crossclassified,1,0,1
6701,structure,vent,hypernymy.1,1,0,1
6695,backstop,dugout,crossclassified,1,0,1
6694,dugout,etna,crossclassified,1,1,0
6688,collar,dog,crossclassified,1,0,1
6686,bread,dessert,crossclassified,1,1,0
6683,basket,pot,co-hyponymy,1,0,1
6753,bag,turkey,crossclassified,1,0,1
6755,turkey,washbasin,crossclassified,1,1,0
6815,boathouse,house,crossclassified,1,0,1
6798,guests,woman,crossclassified,1,0,1
6785,neck,zebra,crossclassified,1,0,1
6791,daddy,sidecar,crossclassified,1,0,1
6793,pepsi,shirt,crossclassified,1,0,1
6794,table,trunk,crossclassified,1,1,0
6795,cookie,cupcake,co-hyponymy,1,0,1
6796,cupcake,nuts,crossclassified,1,1,0
6799,group,woman,hypernymy.1,1,0,1
6756,potatoes,turkey,crossclassified,1,0,1
6800,train,worker,crossclassified,1,1,0
6803,bench,bouquet,crossclassified,1,1,0
6805,belt,skater,crossclassified,1,0,1
6806,sweater,turtleneck,hypernymy.1,1,1,0
6811,marine,suit,crossclassified,1,0,1
6814,house,shelter,crossclassified,1,1,0
6784,boat,woodman,crossclassified,1,1,0
6783,burger,hat,crossclassified,1,0,1
6780,bowl,spurts,crossclassified,1,1,0
6779,vanda,woman,crossclassified,1,0,1
6778,broken,desk,crossclassified,1,0,1
6777,candles,couch,crossclassified,1,0,1
6775,eagle,vest,crossclassified,1,0,1
6774,bus,buses,synonymy,1,1,0
6770,bologna,sandwich,crossclassified,1,0,1
6769,child,costume,crossclassified,1,1,0
6768,cup,lid,crossclassified,1,1,0
6766,bread,chili,crossclassified,1,0,1
6765,burglar,chili,crossclassified,1,0,1
6763,bun,chili,crossclassified,1,0,1
6762,chili,sandwich,crossclassified,1,1,0
6761,chili,filling,crossclassified,1,1,0
6760,chili,tray,crossclassified,1,1,0
6936,button,coat,crossclassified,1,0,1
6938,counter,kettle,crossclassified,1,1,0
6949,city,street,crossclassified,1,0,1
7157,artwork,plant,crossclassified,1,0,1
7146,flower,girl,crossclassified,1,0,1
7147,head,shirt,crossclassified,1,0,1
7149,burrito,pizza,co-hyponymy,1,0,1
7151,coat,restaurant,crossclassified,1,0,1
7152,restaurant,wall,crossclassified,1,1,0
7153,pants,restaurant,crossclassified,1,0,1
7158,costume,plant,crossclassified,1,0,1
7181,pot,sink,co-hyponymy,1,0,1
7159,plant,seedpods,crossclassified,1,1,0
7161,platform,rug,crossclassified,1,0,1
7163,buckle,jacket,crossclassified,1,0,1
7167,dog,tree,crossclassified,1,1,0
7169,cabinet,cabinetmaking,crossclassified,1,1,0
7176,boat,plastic,crossclassified,1,1,0
7143,cow,scarecrow,crossclassified,1,1,0
7137,cat,comb,crossclassified,1,1,0
7134,pickle,zucchini,crossclassified,1,1,0
7131,coach,man,crossclassified,1,0,1
7129,bowl,potato,crossclassified,1,1,0
7125,baby,wheel,crossclassified,1,1,0
7124,baby,human,crossclassified,1,1,0
7123,poor,shirt,crossclassified,1,0,1
7119,shirt,trainer,crossclassified,1,1,0
7117,men,skateboarder,crossclassified,1,0,1
7116,cow,mule,crossclassified,1,1,0
7115,cow,robe,crossclassified,1,1,0
7112,man,promote,crossclassified,1,1,0
7108,child,fresh,crossclassified,1,1,0
7107,child,ice,crossclassified,1,1,0
7105,rice,utensil,crossclassified,1,1,0
7103,lamp,wooden,crossclassified,1,1,0
7177,dog,staring,crossclassified,1,1,0
7183,car,fruit,crossclassified,1,1,0
7101,cat,leaf,crossclassified,1,1,0
7230,chest,dress,crossclassified,1,0,1
7221,box,dish,co-hyponymy,1,0,1
7222,coat,motorcycle,crossclassified,1,0,1
7223,hand,meat,crossclassified,1,1,0
7225,burka,hand,crossclassified,1,0,1
7226,burger,hand,crossclassified,1,0,1
7227,cake,hand,crossclassified,1,0,1
7232,house,vehicle,crossclassified,1,1,0
7184,car,hatch,crossclassified,1,1,0
7233,couch,house,crossclassified,1,0,1
7234,counter,pen,crossclassified,1,1,0
7235,counter,mat,crossclassified,1,1,0
7238,animal,plushy,crossclassified,1,1,0
7243,jug,man,crossclassified,1,0,1
7244,cub,man,crossclassified,1,0,1
7220,bent,dish,crossclassified,1,0,1
7219,dish,fries,crossclassified,1,1,0
7216,desk,rope,crossclassified,1,1,0
7214,airplane,skater,crossclassified,1,0,1
7210,beach,boat,crossclassified,1,0,1
7209,boat,trampoline,crossclassified,1,1,0
7202,spinach,table,crossclassified,1,0,1
7198,bed,rack,crossclassified,1,1,0
7196,bread,sandwiches,crossclassified,1,1,0
7194,cake,monster,crossclassified,1,1,0
7193,cake,picture,crossclassified,1,1,0
7192,cake,sheet,crossclassified,1,1,0
7190,drink,vase,crossclassified,1,0,1
7189,child,cover,crossclassified,1,1,0
7187,dog,leaf,crossclassified,1,1,0
7186,cloth,dog,crossclassified,1,0,1
7185,car,sub,crossclassified,1,1,0
7102,chopper,helicopter,synonymy,1,0,1
7100,man,sleeping,crossclassified,1,1,0
6952,jacket,okay,crossclassified,1,1,0
7003,jug,plant,crossclassified,1,0,1
6990,donut,sauce,crossclassified,1,0,1
6993,nut,sauce,crossclassified,1,0,1
6996,jam,sauce,crossclassified,1,0,1
6997,count,sheep,crossclassified,1,0,1
6999,female,player,co-hyponymy,1,0,1
7000,grass,plant,hypernymy.2,1,0,1
7007,cumberland,shirt,crossclassified,1,0,1
7029,furnace,oven,crossclassified,1,0,1
7008,horse,plant,crossclassified,1,1,0
7011,book,person,crossclassified,1,0,1
7014,flower,seed,crossclassified,1,1,0
7015,flower,fruit,co-hyponymy,1,1,0
7018,cow,cowman,crossclassified,1,1,0
7024,tomato,truck,crossclassified,1,0,1
6987,dress,garment,co-hyponymy,1,1,0
6986,man,socket,crossclassified,1,1,0
6985,clown,man,crossclassified,1,0,1
6984,man,model,crossclassified,1,1,0
6983,bench,stair,crossclassified,1,1,0
6982,bench,street,crossclassified,1,1,0
6980,art,train,crossclassified,1,0,1
6979,bole,train,crossclassified,1,0,1
6977,child,playing,crossclassified,1,1,0
6976,soup,vegetates,crossclassified,1,1,0
6975,bowel,soup,crossclassified,1,0,1
6974,baker,shirt,crossclassified,1,0,1
6969,apron,t-shirt,crossclassified,1,1,0
6968,apron,outfit,crossclassified,1,1,0
6961,elephant,horse,crossclassified,1,1,0
6960,elephant,tapestry,crossclassified,1,1,0
6957,bridge,people,crossclassified,1,1,0
7028,building,restraint,crossclassified,1,1,0
7032,mission,oven,crossclassified,1,0,1
7099,rug,stool,crossclassified,1,1,0
7087,burger,sweater,crossclassified,1,0,1
7078,coat,tunic,crossclassified,1,1,0
7079,coat,duster,crossclassified,1,1,0
7080,clothes,coat,crossclassified,1,0,1
7082,cake,dewy,crossclassified,1,1,0
7083,shoe,train,crossclassified,1,0,1
7085,shirt,sundae,crossclassified,1,1,0
7089,fin,wing,crossclassified,1,0,1
7038,picture,pitcher,crossclassified,1,0,1
7090,ledge,wing,crossclassified,1,0,1
7091,mounting,wing,crossclassified,1,0,1
7093,building,surfboard,crossclassified,1,1,0
7094,garret,grill,crossclassified,1,0,1
7095,buffet,fruit,crossclassified,1,0,1
7097,bottle,rug,crossclassified,1,0,1
7072,board,skateboard,hypernymy.1,1,0,1
7069,child,son,hypernymy.1,1,1,0
7068,jacket,mensuration,crossclassified,1,1,0
7065,armband,jersey,crossclassified,1,0,1
7061,curtain,teen,crossclassified,1,1,0
7054,broccoli,veg,hypernymy.2,1,1,0
7053,bowel,broccoli,crossclassified,1,0,1
7051,person,student,hypernymy.1,1,1,0
7050,person,plate,crossclassified,1,1,0
7049,carpet,footboard,crossclassified,1,1,0
7047,carpet,frame,crossclassified,1,1,0
7046,rig,zebra,crossclassified,1,0,1
7045,fist,jacket,crossclassified,1,0,1
7043,catcher,keeper,crossclassified,1,1,0
7042,bread,dough,synonymy,1,1,0
7041,bread,gloves,crossclassified,1,1,0
7040,boy,pipe,crossclassified,1,1,0
6682,pot,urn,hypernymy.1,1,1,0
6681,beer,cabinet,crossclassified,1,0,1
6679,hotdog,sausages,hypernymy.2,1,1,0
6276,couple,married,crossclassified,1,1,0
6252,hidden,woman,crossclassified,1,0,1
6257,mound,sand,crossclassified,1,1,0
6261,man,violin,crossclassified,1,1,0
6264,jack,vase,crossclassified,1,0,1
6266,bird,cycle,crossclassified,1,1,0
6274,couple,hand,crossclassified,1,1,0
6277,cake,couple,crossclassified,1,0,1
6305,drinks,glass,crossclassified,1,0,1
6278,couple,tie,crossclassified,1,1,0
6289,animals,horse,hypernymy.1,1,0,1
6291,desk,mixer,crossclassified,1,1,0
6293,casserole,pasta,co-hyponymy,1,0,1
6295,calves,cow,crossclassified,1,0,1
6299,foam,wave,crossclassified,1,0,1
6248,rug,runway,crossclassified,1,1,0
6247,curtain,rug,co-hyponymy,1,0,1
6243,deck,train,crossclassified,1,0,1
6240,juice,soup,crossclassified,1,0,1
6238,snacks,soup,crossclassified,1,0,1
6236,advertisement,dugout,crossclassified,1,0,1
6235,kid,leg,crossclassified,1,0,1
6234,leg,outfit,crossclassified,1,1,0
6228,bathtub,indoor,crossclassified,1,1,0
6225,branch,woman,crossclassified,1,0,1
6223,boy,mirror,crossclassified,1,1,0
6222,conductor,man,crossclassified,1,0,1
6220,captain,man,hypernymy.2,1,0,1
6215,box,dugout,crossclassified,1,0,1
6213,bread,loaf,hypernymy.1,1,1,0
6211,pool,truck,crossclassified,1,0,1
6205,jeep,skate,crossclassified,1,1,0
6304,glass,goblet,hypernymy.1,1,1,0
6307,chest,coat,crossclassified,1,0,1
6203,jeep,skateboard,crossclassified,1,1,0
6360,animal,roof,crossclassified,1,0,1
6349,desk,paraphernalia,crossclassified,1,1,0
6350,box,man,crossclassified,1,0,1
6352,fancy,man,crossclassified,1,0,1
6353,boys,car,crossclassified,1,0,1
6354,overhang,roof,crossclassified,1,0,1
6356,roof,tilt,crossclassified,1,1,0
6365,cover,giraffe,crossclassified,1,0,1
6310,mountain,snowboarder,crossclassified,1,0,1
6367,dress,tank,crossclassified,1,1,0
6370,chair,female,crossclassified,1,1,0
6371,chair,uniform,crossclassified,1,1,0
6372,jacket,neck,crossclassified,1,1,0
6374,bun,child,crossclassified,1,0,1
6376,cat,pan,crossclassified,1,0,1
6347,box,bread,crossclassified,1,0,1
6343,necks,zebra,crossclassified,1,0,1
6341,daughter,girl,synonymy,1,0,1
6338,sandwiches,table,crossclassified,1,0,1
6336,bathtub,restroom,crossclassified,1,1,0
6333,counter,electronics,crossclassified,1,1,0
6330,concrete,woman,crossclassified,1,0,1
6329,boy,goggles,crossclassified,1,1,0
6328,pilgrim,woman,crossclassified,1,0,1
6327,airplane,people,crossclassified,1,1,0
6326,couch,salad,crossclassified,1,1,0
6324,cup,lamp,crossclassified,1,0,1
6322,heater,lamp,crossclassified,1,0,1
6321,chocolate,cup,crossclassified,1,0,1
6313,dugout,shoes,crossclassified,1,1,0
6312,lat,woman,crossclassified,1,0,1
6311,car,crape,crossclassified,1,1,0
6204,jeep,pants,crossclassified,1,1,0
6202,jeep,snowboard,crossclassified,1,1,0
6379,australian,dog,crossclassified,1,0,1
6121,carpet,dugout,crossclassified,1,1,0
6100,pants,shirt,co-hyponymy,1,0,1
6110,fryer,grill,crossclassified,1,0,1
6115,mitt,mitten,crossclassified,1,0,1
6116,mitten,table,crossclassified,1,1,0
6117,desk,handle,crossclassified,1,1,0
6119,avos,bed,crossclassified,1,0,1
6122,grill,toast,crossclassified,1,1,0
6140,apple,sandwich,crossclassified,1,1,0
6125,chair,plates,crossclassified,1,1,0
6130,person,wine,crossclassified,1,1,0
6131,cup,person,crossclassified,1,0,1
6134,drinks,person,crossclassified,1,0,1
6136,apple,class,crossclassified,1,1,0
6137,apple,chip,crossclassified,1,1,0
6099,pocket,shirt,crossclassified,1,0,1
6098,shirt,waistband,crossclassified,1,1,0
6095,italian,pizza,crossclassified,1,0,1
6093,blender,electronics,crossclassified,1,1,0
6092,blender,michigander,crossclassified,1,1,0
6091,jacket,umpire,crossclassified,1,0,1
6089,animal,scooter,hypernymy.1,1,0,1
6088,counter,snacking,crossclassified,1,1,0
6084,giraffe,ostrich,crossclassified,1,0,1
6083,ostrich,wooden,crossclassified,1,1,0
6082,animal,ostrich,hypernymy.1,1,0,1
6079,food,oats,hypernymy.1,1,1,0
6078,boy,oil,crossclassified,1,1,0
6076,apart,building,crossclassified,1,0,1
6075,furniture,giraffe,crossclassified,1,0,1
6074,microwave,pan,crossclassified,1,0,1
6073,flower,jar,crossclassified,1,1,0
6139,apple,tart,crossclassified,1,1,0
6142,clothing,skier,crossclassified,1,0,1
6201,jeep,skier,crossclassified,1,1,0
6186,abode,house,hypernymy.1,1,0,1
6178,cream,food,hypernymy.2,1,0,1
6179,swimsuit,umbrella,crossclassified,1,0,1
6181,stomach,umbrella,crossclassified,1,0,1
6182,clothing,umbrella,crossclassified,1,0,1
6183,bikini,umbrella,crossclassified,1,0,1
6184,elbow,umbrella,crossclassified,1,0,1
6189,phone,sweater,crossclassified,1,0,1
6144,person,walker,hypernymy.1,1,1,0
6190,listener,man,crossclassified,1,0,1
6192,man,monitor,crossclassified,1,1,0
6193,button,tie,co-hyponymy,1,0,1
6198,chair,shelf,crossclassified,1,0,1
6199,train,trained,crossclassified,1,1,0
6200,bleachers,bridge,crossclassified,1,0,1
6176,bush,house,crossclassified,1,0,1
6173,curtain,flowerpot,crossclassified,1,1,0
6172,bird,blackbird,hypernymy.1,1,1,0
6170,cigar,man,crossclassified,1,0,1
6169,food,wanton,crossclassified,1,1,0
6168,basil,food,hypernymy.2,1,0,1
6165,food,tempura,hypernymy.1,1,1,0
6163,food,scones,hypernymy.1,1,1,0
6160,pajama,shirt,crossclassified,1,0,1
6159,cartridge,train,crossclassified,1,0,1
6158,kerchief,skier,crossclassified,1,0,1
6155,ball,carpet,crossclassified,1,0,1
6153,dress,drink,crossclassified,1,1,0
6152,boy,friend,crossclassified,1,1,0
6151,bench,boom,crossclassified,1,1,0
6150,child,mirror,crossclassified,1,1,0
6149,child,pusher,crossclassified,1,1,0
6377,pan,veritable,crossclassified,1,1,0
6381,coat,reader,crossclassified,1,1,0
6678,hotdog,wieners,synonymy,1,1,0
6595,bread,veg,crossclassified,1,1,0
6580,decoration,giraffe,crossclassified,1,0,1
6581,doll,giraffe,crossclassified,1,0,1
6582,cheese,child,crossclassified,1,0,1
6586,man,vase,crossclassified,1,1,0
6591,dust,truck,crossclassified,1,0,1
6592,bench,music,crossclassified,1,1,0
6599,ice,skier,crossclassified,1,0,1
6608,matte,sandwich,crossclassified,1,0,1
6600,gut,shirt,crossclassified,1,0,1
6601,tide,wave,crossclassified,1,0,1
6602,wave,whitecap,hypernymy.1,1,1,0
6603,lamp,sconce,crossclassified,1,1,0
6604,lamp,stand,crossclassified,1,1,0
6605,lamp,sofa,crossclassified,1,1,0
6576,bathtub,mat,crossclassified,1,1,0
6575,pizza,relish,crossclassified,1,0,1
6574,bun,relish,crossclassified,1,0,1
6573,ketchup,relish,co-hyponymy,1,0,1
6570,relish,sauce,co-hyponymy,1,1,0
6567,grate,ground,crossclassified,1,1,0
6556,house,playhouse,crossclassified,1,1,0
6555,boater,boy,crossclassified,1,0,1
6554,boy,lifesaver,crossclassified,1,1,0
6552,chair,chin,crossclassified,1,1,0
6551,backpacker,woman,crossclassified,1,0,1
6545,car,peacock,crossclassified,1,1,0
6541,hat,human,crossclassified,1,1,0
6540,hat,headband,crossclassified,1,1,0
6536,chili,soup,co-hyponymy,1,0,1
6535,cabinet,floor,crossclassified,1,1,0
6534,cabinet,scissors,crossclassified,1,1,0
6606,man,serve,crossclassified,1,1,0
6609,bed,tent,crossclassified,1,0,1
6528,corgi,dog,hypernymy.2,1,0,1
6662,cake,things,crossclassified,1,1,0
6644,man,screen,crossclassified,1,1,0
6646,horse,ring,crossclassified,1,1,0
6647,couch,newspaper,crossclassified,1,1,0
6652,egg,toast,crossclassified,1,0,1
6654,jacket,lanyard,crossclassified,1,1,0
6655,man,typist,crossclassified,1,1,0
6663,carpet,girl,crossclassified,1,1,0
6610,bodice,dress,crossclassified,1,0,1
6665,carpet,paper,crossclassified,1,1,0
6669,chair,donuts,crossclassified,1,1,0
6670,chair,windowsill,crossclassified,1,1,0
6672,cow,mannequin,crossclassified,1,1,0
6675,ball,batter,crossclassified,1,0,1
6676,giraffe,height,crossclassified,1,1,0
6643,pajamas,shirt,crossclassified,1,0,1
6642,girlish,woman,crossclassified,1,0,1
6641,plaid,woman,crossclassified,1,0,1
6640,bridge,headlights,crossclassified,1,1,0
6639,ball,lemon,crossclassified,1,0,1
6637,lemon,plate,crossclassified,1,1,0
6633,butt,giraffe,crossclassified,1,0,1
6631,car,engine,crossclassified,1,1,0
6630,apple,furniture,crossclassified,1,1,0
6622,bed,bill,crossclassified,1,1,0
6621,bow,jacket,crossclassified,1,0,1
6618,guy,pitcher,crossclassified,1,0,1
6617,pitcher,uniform,crossclassified,1,1,0
6615,bench,shirty,crossclassified,1,1,0
6614,bench,compartment,crossclassified,1,1,0
6613,food,takeout,hypernymy.1,1,1,0
6611,dress,shortstop,crossclassified,1,1,0
6532,jar,planter,crossclassified,1,0,1
6524,boll,man,crossclassified,1,0,1
6382,cane,coat,crossclassified,1,0,1
6430,hat,umpire,crossclassified,1,0,1
6422,desk,homeotherm,crossclassified,1,1,0
6423,cleats,man,crossclassified,1,0,1
6424,chest,man,crossclassified,1,0,1
6425,fish,hotdog,crossclassified,1,0,1
6426,boat,number,crossclassified,1,1,0
6427,human,umpire,crossclassified,1,0,1
6432,burger,guacamole,crossclassified,1,0,1
6454,box,dog,crossclassified,1,1,0
6434,condiment,guacamole,hypernymy.1,1,0,1
6435,guacamole,vegetables,crossclassified,1,1,0
6437,guacamole,hotdog,crossclassified,1,1,0
6438,guacamole,snacks,crossclassified,1,1,0
6441,children,woman,crossclassified,1,0,1
6447,donut,ring,crossclassified,1,1,0
6421,desk,fridge,crossclassified,1,1,0
6416,baby,sweater,co-hyponymy,1,1,0
6414,desk,objects,hypernymy.2,1,1,0
6412,chest,suit,crossclassified,1,0,1
6410,chest,woman,crossclassified,1,0,1
6409,brute,man,hypernymy.1,1,0,1
6405,food,restaurant,crossclassified,1,0,1
6400,flower,window,co-hyponymy,1,1,0
6398,bun,pepper,crossclassified,1,1,0
6397,bun,jalapeno,crossclassified,1,1,0
6395,airport,bridge,crossclassified,1,0,1
6394,bridge,jet,crossclassified,1,1,0
6393,child,hotdog,crossclassified,1,0,1
6389,fruit,lime,hypernymy.1,1,0,1
6387,boy,trouser,crossclassified,1,1,0
6384,hotdog,pita,crossclassified,1,1,0
6383,coat,furniture,crossclassified,1,1,0
6453,cellphone,turban,crossclassified,1,0,1
6455,fans,man,crossclassified,1,0,1
6523,bit,horse,crossclassified,1,0,1
6502,shrimp,table,crossclassified,1,0,1
6494,building,chapel,hypernymy.1,1,1,0
6495,building,carte,crossclassified,1,1,0
6496,daisy,flower,hypernymy.2,1,0,1
6497,girl,scut,crossclassified,1,1,0
6499,boy,smile,crossclassified,1,1,0
6501,sushi,table,crossclassified,1,0,1
6505,chair,grill,crossclassified,1,1,0
6456,man,parser,crossclassified,1,1,0
6508,bronco,bull,crossclassified,1,0,1
6510,bull,rodeo,crossclassified,1,1,0
6511,bull,person,hypernymy.2,1,1,0
6512,bull,cap,crossclassified,1,1,0
6520,bored,sign,crossclassified,1,0,1
6521,sign,store,crossclassified,1,1,0
6493,hand,sweater,crossclassified,1,0,1
6492,sidewalk,water,crossclassified,1,1,0
6491,sidewalk,stone,crossclassified,1,1,0
6490,seawall,sidewalk,crossclassified,1,0,1
6488,damn,sidewalk,crossclassified,1,0,1
6487,sidewalk,trail,crossclassified,1,1,0
6485,park,sidewalk,crossclassified,1,0,1
6484,driveway,sidewalk,crossclassified,1,0,1
6482,truck,women,crossclassified,1,1,0
6481,man,missionary,crossclassified,1,1,0
6476,counter,pastries,crossclassified,1,1,0
6473,desk,work,crossclassified,1,1,0
6470,condiment,food,hypernymy.2,1,0,1
6465,cherry,spoon,crossclassified,1,0,1
6464,cherries,spoon,crossclassified,1,0,1
6459,passionflower,sink,crossclassified,1,0,1
6458,faucal,sink,crossclassified,1,0,1
4633,joystick,woman,crossclassified,1,0,1
4626,hitter,woman,crossclassified,1,0,1
7246,cover,dog,crossclassified,1,0,1
2128,food,nuggets,crossclassified,1,1,0
2105,grill,pan,crossclassified,1,1,0
2109,table,veg,crossclassified,1,1,0
2110,pul,train,crossclassified,1,0,1
2114,bridge,buildings,co-hyponymy,1,1,0
2121,guy,umpire,crossclassified,1,0,1
2125,pant,umpire,crossclassified,1,0,1
2129,food,peas,hypernymy.1,1,1,0
2099,bowl,china,crossclassified,1,0,1
2132,paper,umbrella,crossclassified,1,0,1
2134,umbrella,unknown,crossclassified,1,1,0
2136,pillar,umbrella,crossclassified,1,0,1
2139,colors,umbrella,crossclassified,1,0,1
2143,table,teaberry,crossclassified,1,1,0
2144,pizza,plane,crossclassified,1,1,0
2100,china,pottery,crossclassified,1,1,0
2098,china,pot,crossclassified,1,1,0
2820,boat,gloves,crossclassified,1,1,0
2068,glasses,suit,crossclassified,1,0,1
2056,castle,trafficking,crossclassified,1,1,0
2057,headband,skier,crossclassified,1,0,1
2064,cucumber,orange,crossclassified,1,1,0
2065,truck,wreck,crossclassified,1,1,0
2066,jalopy,truck,crossclassified,1,0,1
2067,machinery,truck,crossclassified,1,0,1
2072,bags,skier,crossclassified,1,0,1
2097,china,glassware,crossclassified,1,1,0
2077,divider,man,co-hyponymy,1,0,1
2081,doorway,dugout,crossclassified,1,0,1
2084,body,dugout,crossclassified,1,0,1
2090,child,picker,co-hyponymy,1,1,0
2095,china,vases,crossclassified,1,1,0
2096,china,porcelain,hypernymy.2,1,1,0
2146,faucet,man,crossclassified,1,0,1
2152,bowl,steel,crossclassified,1,1,0
2154,stylist,woman,crossclassified,1,0,1
2251,hat,toboggan,crossclassified,1,1,0
2228,basket,cat,crossclassified,1,0,1
2230,kalamazoo,pizza,crossclassified,1,0,1
2233,baby,curtain,crossclassified,1,0,1
2242,dugout,judges,crossclassified,1,1,0
2244,meeting,table,co-hyponymy,1,0,1
2249,egg,rice,crossclassified,1,0,1
2255,transportation,woman,crossclassified,1,0,1
2156,couch,guy,crossclassified,1,1,0
2274,building,office,crossclassified,1,1,0
2279,bandana,shirt,crossclassified,1,0,1
2281,back,jacket,crossclassified,1,0,1
2296,cookie,croissant,crossclassified,1,0,1
2303,airport,car,crossclassified,1,1,0
2304,airport,airway,crossclassified,1,1,0
2224,swan,wood,crossclassified,1,1,0
2219,boat,wire,crossclassified,1,1,0
2218,garage,mirror,crossclassified,1,1,0
2217,garage,vehicle,crossclassified,1,1,0
2216,door,garage,crossclassified,1,0,1
2215,garage,window,crossclassified,1,1,0
2194,politician,woman,crossclassified,1,0,1
2187,flannel,man,crossclassified,1,0,1
2183,cow,muzzle,crossclassified,1,1,0
2177,burger,tray,crossclassified,1,0,1
2176,placeman,tray,crossclassified,1,0,1
2174,fork,tray,crossclassified,1,0,1
2173,spool,tray,crossclassified,1,0,1
2168,appetizer,cupcake,crossclassified,1,0,1
2167,cupcake,mousse,crossclassified,1,1,0
2163,cupcake,pie,crossclassified,1,1,0
2157,boy,oven,crossclassified,1,1,0
2055,castle,towers,crossclassified,1,1,0
2053,cabinet,things,crossclassified,1,1,0
2048,prayer,woman,crossclassified,1,0,1
1866,bridge,caves,crossclassified,1,1,0
1824,jacket,snowsuit,crossclassified,1,1,0
1827,house,post,crossclassified,1,1,0
1829,cactus,house,crossclassified,1,0,1
1831,house,singapore,crossclassified,1,1,0
1841,coat,house,crossclassified,1,0,1
1861,bridge,rocks,crossclassified,1,1,0
1868,couch,slacks,crossclassified,1,1,0
1893,doll,pillow,crossclassified,1,0,1
1878,house,scissor,crossclassified,1,1,0
1881,bone,dog,crossclassified,1,0,1
1882,acrobat,skier,co-hyponymy,1,0,1
1883,skier,skiing,crossclassified,1,1,0
1887,cushion,pillow,hypernymy.1,1,0,1
1888,beanie,pillow,crossclassified,1,0,1
1821,bread,hamburger,crossclassified,1,0,1
1808,lips,shirt,crossclassified,1,0,1
1802,railing,truck,crossclassified,1,0,1
1801,carriage,truck,crossclassified,1,0,1
1789,belt,sweater,crossclassified,1,0,1
1788,harness,sweater,crossclassified,1,0,1
1783,mushrooms,pizza,crossclassified,1,0,1
1782,beetle,car,crossclassified,1,0,1
1781,buggy,car,crossclassified,1,0,1
1779,couch,players,crossclassified,1,1,0
1778,controls,couch,crossclassified,1,0,1
1777,balloon,sky,crossclassified,1,1,0
1776,balloon,jacket,crossclassified,1,1,0
1770,fridge,table,crossclassified,1,0,1
1767,pant,sandwich,crossclassified,1,0,1
1761,garage,t-shirt,crossclassified,1,1,0
1760,garage,jacket,crossclassified,1,1,0
1891,hood,pillow,crossclassified,1,0,1
1898,commuter,jacket,crossclassified,1,0,1
2041,delicacy,food,hypernymy.2,1,0,1
2014,dugout,legs,crossclassified,1,1,0
1988,nose,shirt,crossclassified,1,0,1
1991,blanket,cake,crossclassified,1,0,1
1993,cake,clay,crossclassified,1,1,0
1995,man,pul,crossclassified,1,1,0
1997,bottle,scissor,crossclassified,1,1,0
1999,bench,chaise,crossclassified,1,1,0
2017,ballplayer,dugout,crossclassified,1,0,1
1903,curtain,eyeglass,crossclassified,1,1,0
2018,dugout,seating,crossclassified,1,1,0
2019,benches,dugout,crossclassified,1,0,1
2025,animals,bed,crossclassified,1,0,1
2026,child,shorts,crossclassified,1,1,0
2027,burger,meal,crossclassified,1,1,0
2030,bowl,pasha,crossclassified,1,1,0
1983,pork,spoon,crossclassified,1,0,1
1976,boat,model,crossclassified,1,1,0
1974,hippie,skateboarder,crossclassified,1,0,1
1959,beverage,wine,hypernymy.1,1,0,1
1952,gloves,skater,crossclassified,1,0,1
1950,skater,sky,crossclassified,1,1,0
1948,bench,benched,crossclassified,1,1,0
1945,number,train,crossclassified,1,0,1
1936,boy,guitar,crossclassified,1,1,0
1934,church,train,crossclassified,1,0,1
1919,car,crossover,crossclassified,1,1,0
1918,outfit,skier,crossclassified,1,0,1
1917,jeans,skier,crossclassified,1,0,1
1916,skier,snowsuit,crossclassified,1,1,0
1915,bananas,shirt,crossclassified,1,0,1
1908,dish,mouse,crossclassified,1,0,1
1905,curtain,goldman,crossclassified,1,1,0
2305,airport,airstrip,co-hyponymy,1,1,0
2306,airport,wheel,crossclassified,1,1,0
2310,airport,tarmac,crossclassified,1,1,0
2627,food,van,crossclassified,1,0,1
2613,mixed,pot,crossclassified,1,0,1
2614,bananas,pot,crossclassified,1,0,1
2617,dog,flower,crossclassified,1,1,0
2618,burger,onion,crossclassified,1,1,0
2625,van,worker,crossclassified,1,1,0
2626,chef,van,crossclassified,1,0,1
2628,dress,van,crossclassified,1,0,1
2652,hamlet,man,crossclassified,1,0,1
2635,socks,table,crossclassified,1,0,1
2636,feet,table,crossclassified,1,0,1
2638,horse,satchel,crossclassified,1,1,0
2639,bowel,table,crossclassified,1,0,1
2642,snowboarder,sunglasses,crossclassified,1,1,0
2646,snowboarder,spectacle,crossclassified,1,1,0
2612,dixie,woman,crossclassified,1,0,1
2609,bicycler,man,crossclassified,1,0,1
2604,pigeon,pizza,crossclassified,1,0,1
2601,muumuu,shirt,crossclassified,1,0,1
2600,garb,shirt,crossclassified,1,0,1
2597,shirt,turki,crossclassified,1,1,0
2590,gyro,hotdog,co-hyponymy,1,0,1
2589,fork,hotdog,crossclassified,1,0,1
2583,parrot,tree,crossclassified,1,1,0
2582,grill,vegetable,crossclassified,1,1,0
2581,dinner,grill,crossclassified,1,0,1
2577,tankers,train,crossclassified,1,0,1
2576,boy,father,crossclassified,1,1,0
2556,board,tent,crossclassified,1,0,1
2553,ski,tent,crossclassified,1,0,1
2552,boy,tent,crossclassified,1,0,1
2549,booth,sofa,crossclassified,1,1,0
2651,jockey,man,crossclassified,1,0,1
2654,cat,opossum,crossclassified,1,1,0
2540,peer,table,crossclassified,1,0,1
2782,boat,skid,crossclassified,1,1,0
2757,sink,toiletry,crossclassified,1,1,0
2758,child,wheel,crossclassified,1,1,0
2766,cupcake,spoon,crossclassified,1,1,0
2774,backrest,chair,crossclassified,1,0,1
2775,board,chair,crossclassified,1,0,1
2780,child,headgear,crossclassified,1,1,0
2788,strawberry,table,crossclassified,1,0,1
2655,giraffe,glass,crossclassified,1,1,0
2789,berries,table,crossclassified,1,0,1
2793,toilet,washbasin,crossclassified,1,1,0
2794,cardboard,table,crossclassified,1,0,1
2798,filet,food,hypernymy.2,1,0,1
2803,bile,dog,crossclassified,1,0,1
2804,bridge,tent,crossclassified,1,1,0
2750,cat,steel,crossclassified,1,1,0
2748,bird,osprey,hypernymy.1,1,1,0
2740,bird,ibis,hypernymy.1,1,1,0
2734,auk,vase,crossclassified,1,0,1
2730,flower,jacket,crossclassified,1,0,1
2727,bed,cradle,crossclassified,1,1,0
2725,child,sunglasses,crossclassified,1,1,0
2718,building,yacht,crossclassified,1,1,0
2713,hybrid,zebra,crossclassified,1,0,1
2707,boat,carrier,crossclassified,1,1,0
2694,lettuce,veg,hypernymy.2,1,1,0
2693,flower,lettuce,crossclassified,1,0,1
2681,net,skier,crossclassified,1,0,1
2678,cup,jurist,crossclassified,1,1,0
2675,cup,straw,crossclassified,1,1,0
2668,armoire,desk,crossclassified,1,0,1
2657,sink,towel,crossclassified,1,1,0
2542,heat,sheep,crossclassified,1,0,1
2532,bedpost,carpet,crossclassified,1,0,1
2312,airport,mountains,crossclassified,1,1,0
2398,chair,court,crossclassified,1,1,0
2382,man,road,crossclassified,1,1,0
2386,desk,speaker,crossclassified,1,1,0
2387,desk,sparker,crossclassified,1,1,0
2390,nut,toilet,crossclassified,1,0,1
2391,drum,toilet,crossclassified,1,0,1
2394,hole,toilet,crossclassified,1,0,1
2399,giraffe,newborn,crossclassified,1,1,0
2426,bread,floor,crossclassified,1,1,0
2403,burger,cup,crossclassified,1,0,1
2406,burger,paper,crossclassified,1,1,0
2408,brother,man,crossclassified,1,0,1
2418,bottle,pottery,crossclassified,1,0,1
2420,pottery,teapot,crossclassified,1,1,0
2422,pottery,treasure,crossclassified,1,1,0
2380,bridge,wings,crossclassified,1,1,0
2375,fork,veritable,crossclassified,1,1,0
2369,car,woody,crossclassified,1,1,0
2368,car,eerie,crossclassified,1,1,0
2366,food,spatula,crossclassified,1,0,1
2363,spatula,table,crossclassified,1,1,0
2356,horse,marbles,crossclassified,1,1,0
2354,cat,lamp,crossclassified,1,0,1
2353,lamp,shelves,crossclassified,1,1,0
2352,computer,lamp,crossclassified,1,0,1
2345,children,table,crossclassified,1,0,1
2340,dress,light,crossclassified,1,1,0
2332,hat,swatter,crossclassified,1,1,0
2326,orange,sandwich,crossclassified,1,0,1
2321,boat,wings,crossclassified,1,1,0
2319,chuddar,dress,crossclassified,1,0,1
2314,airport,fog,crossclassified,1,1,0
2424,ceramics,pottery,crossclassified,1,0,1
2429,bread,produce,crossclassified,1,1,0
2531,carpet,steel,crossclassified,1,1,0
2508,manger,shed,crossclassified,1,0,1
2482,diner,table,crossclassified,1,0,1
2483,bird,cow,crossclassified,1,0,1
2490,ground,table,crossclassified,1,0,1
2503,enclosure,shed,crossclassified,1,0,1
2505,shed,stable,crossclassified,1,1,0
2506,shed,structure,hypernymy.2,1,1,0
2509,hutch,shed,crossclassified,1,0,1
2433,bed,hood,crossclassified,1,0,1
2510,shed,sheep,crossclassified,1,1,0
2512,jacket,sweeter,crossclassified,1,1,0
2519,sandal,vase,crossclassified,1,0,1
2520,chapel,vase,crossclassified,1,0,1
2526,cat,tent,crossclassified,1,1,0
2530,carpet,pul,crossclassified,1,1,0
2479,building,skater,crossclassified,1,0,1
2477,sandwich,wooden,crossclassified,1,1,0
2476,fedora,skater,crossclassified,1,0,1
2471,owl,wood,crossclassified,1,1,0
2463,curter,fence,crossclassified,1,0,1
2462,cover,fence,crossclassified,1,0,1
2461,fence,women,crossclassified,1,1,0
2460,fence,grass,crossclassified,1,1,0
2459,fence,racket,crossclassified,1,1,0
2458,fence,plastic,crossclassified,1,1,0
2456,backboard,fence,crossclassified,1,0,1
2454,fence,sleeveless,crossclassified,1,1,0
2453,court,fence,crossclassified,1,0,1
2452,fence,watch,crossclassified,1,1,0
2444,dog,puppies,hypernymy.1,1,1,0
2442,donuts,woman,crossclassified,1,0,1
2441,doughnuts,woman,crossclassified,1,0,1
1758,garage,shorts,crossclassified,1,1,0
1752,bathtub,luxuriousness,crossclassified,1,1,0
1742,boy,shirted,crossclassified,1,1,0
766,granola,table,crossclassified,1,0,1
705,blender,mug,crossclassified,1,1,0
706,blender,utensils,hypernymy.2,1,1,0
707,blender,spoons,crossclassified,1,1,0
749,homeless,man,crossclassified,1,0,1
762,sacrifice,sheep,crossclassified,1,0,1
763,knife,sheep,crossclassified,1,0,1
767,nuts,table,crossclassified,1,0,1
837,shirt,straps,crossclassified,1,1,0
781,male,pitcher,crossclassified,1,0,1
789,reach,woman,crossclassified,1,0,1
803,bunny,glass,crossclassified,1,0,1
805,glass,whiskey,crossclassified,1,1,0
807,glass,logo,crossclassified,1,1,0
823,boy,lade,crossclassified,1,1,0
692,man,rack,crossclassified,1,1,0
690,book,cow,crossclassified,1,0,1
688,pitcher,teenager,crossclassified,1,1,0
671,handshake,sink,crossclassified,1,0,1
668,faucet,hose,crossclassified,1,1,0
667,faucet,pipe,crossclassified,1,1,0
666,faucet,handheld,crossclassified,1,1,0
665,faucet,fixture,crossclassified,1,1,0
664,faucet,shower,crossclassified,1,1,0
663,faucet,ship,crossclassified,1,1,0
651,child,mother,crossclassified,1,1,0
642,bowl,veg,crossclassified,1,1,0
641,bowl,chips,crossclassified,1,1,0
631,tragus,truck,crossclassified,1,0,1
619,house,tractor,crossclassified,1,1,0
606,outside,table,crossclassified,1,0,1
605,boy,harness,crossclassified,1,1,0
831,core,truck,crossclassified,1,0,1
851,food,tofu,hypernymy.1,1,1,0
603,boy,ground,crossclassified,1,1,0
968,giraffe,human,crossclassified,1,1,0
955,marina,waterway,crossclassified,1,1,0
957,marina,seaport,crossclassified,1,1,0
958,city,marina,crossclassified,1,0,1
964,faucet,woman,crossclassified,1,0,1
965,piss,pizza,crossclassified,1,0,1
967,giraffe,kid,crossclassified,1,1,0
969,giraffe,lady,crossclassified,1,1,0
870,bone,child,crossclassified,1,0,1
975,dish,wrap,hypernymy.1,1,0,1
979,rover,truck,crossclassified,1,0,1
985,soup,veg,crossclassified,1,1,0
992,dress,sportswear,hypernymy.1,1,1,0
995,band,dress,crossclassified,1,0,1
996,dress,wristband,crossclassified,1,1,0
949,marina,town,crossclassified,1,1,0
947,ham,sandwich,crossclassified,1,0,1
943,giraffe,sculpture,crossclassified,1,1,0
939,counter,crock,crossclassified,1,1,0
935,ostrich,sheep,crossclassified,1,0,1
934,bench,towel,crossclassified,1,1,0
911,faucet,hydrant,hypernymy.1,1,0,1
910,bonnet,hydrant,crossclassified,1,0,1
909,bolt,hydrant,crossclassified,1,0,1
905,hydrant,top,crossclassified,1,1,0
904,bread,dish,crossclassified,1,1,0
900,crane,goose,crossclassified,1,0,1
892,bench,vehicles,crossclassified,1,1,0
886,apportionment,streetlight,crossclassified,1,0,1
881,post,streetlight,crossclassified,1,0,1
875,plate,shortcake,crossclassified,1,1,0
871,adust,sheep,crossclassified,1,0,1
604,boy,chain,crossclassified,1,1,0
586,giraffe,vehicle,crossclassified,1,1,0
1003,head,suit,crossclassified,1,0,1
245,bench,crate,crossclassified,1,1,0
157,plane,shuttle,crossclassified,1,1,0
163,dog,rail,crossclassified,1,1,0
174,dining,floor,crossclassified,1,0,1
191,controller,jacket,crossclassified,1,0,1
197,sunflower,table,crossclassified,1,0,1
200,armband,woman,crossclassified,1,0,1
259,pier,walkway,crossclassified,1,1,0
297,hood,trunk,crossclassified,1,1,0
260,guardrail,pier,crossclassified,1,0,1
261,pier,ship,crossclassified,1,1,0
262,pier,table,crossclassified,1,1,0
271,lettuce,scallions,crossclassified,1,1,0
280,bench,bola,crossclassified,1,1,0
284,dog,greyhound,hypernymy.1,1,1,0
143,bathroom,robe,crossclassified,1,0,1
141,robe,screen,crossclassified,1,1,0
138,bathtub,robe,crossclassified,1,0,1
133,poles,train,crossclassified,1,0,1
112,controllership,shirt,crossclassified,1,0,1
110,surfboard,truck,crossclassified,1,0,1
103,bird,boy,crossclassified,1,0,1
98,pig,shirt,crossclassified,1,0,1
95,bathtub,rod,crossclassified,1,1,0
94,bathtub,steel,crossclassified,1,1,0
93,bathtub,furniture,crossclassified,1,1,0
89,bathtub,fence,crossclassified,1,1,0
77,dugout,guardrail,crossclassified,1,1,0
71,dugout,path,crossclassified,1,1,0
66,bean,salad,crossclassified,1,0,1
22,suitcase,van,crossclassified,1,0,1
18,tailgate,van,crossclassified,1,0,1
290,duck,swam,crossclassified,1,1,0
302,seat,setback,crossclassified,1,1,0
575,court,vest,crossclassified,1,0,1
502,letter,shirt,crossclassified,1,0,1
470,poncho,umbrella,crossclassified,1,1,0
479,ram,yak,crossclassified,1,1,0
482,buffalo,ram,crossclassified,1,0,1
494,carrot,fruit,crossclassified,1,1,0
497,carrot,produce,hypernymy.2,1,1,0
501,camper,tent,crossclassified,1,0,1
524,fence,plane,crossclassified,1,0,1
305,seat,window,crossclassified,1,1,0
534,dresser,mouse,co-hyponymy,1,1,0
537,mouse,shirt,crossclassified,1,0,1
548,man,sheet,crossclassified,1,1,0
559,bagel,shirt,crossclassified,1,0,1
565,bird,coil,crossclassified,1,1,0
574,die,vest,crossclassified,1,0,1
469,man,poncho,crossclassified,1,0,1
468,poncho,protestant,crossclassified,1,1,0
467,coat,poncho,crossclassified,1,0,1
466,girl,poncho,crossclassified,1,0,1
465,parka,poncho,crossclassified,1,0,1
456,counter,microprocessor,crossclassified,1,1,0
441,carpet,shag,crossclassified,1,1,0
418,man,team,crossclassified,1,1,0
410,pizza,sushi,co-hyponymy,1,1,0
400,crust,platter,crossclassified,1,1,0
397,crust,edge,crossclassified,1,1,0
389,child,portrait,crossclassified,1,1,0
370,armband,dress,crossclassified,1,0,1
367,dress,tennis,crossclassified,1,1,0
364,icebreaker,skier,crossclassified,1,0,1
350,boy,plat,crossclassified,1,1,0
313,runner,table,crossclassified,1,0,1
1001,container,mug,hypernymy.1,1,0,1
1009,building,monastery,hypernymy.1,1,1,0
1739,fixture,toilet,hypernymy.1,1,0,1
1513,child,couple,crossclassified,1,0,1
1496,airplane,tailplane,crossclassified,1,1,0
1497,airplane,crash,crossclassified,1,1,0
1499,guy,tie,co-hyponymy,1,0,1
1507,chair,tall,crossclassified,1,1,0
1511,couple,pair,synonymy,1,1,0
1512,couple,plate,crossclassified,1,1,0
1514,couple,tree,crossclassified,1,1,0
1534,pie,table,crossclassified,1,0,1
1516,couple,teen,crossclassified,1,1,0
1517,couple,teenagers,crossclassified,1,1,0
1519,couple,siblings,crossclassified,1,1,0
1525,jacket,magic,crossclassified,1,1,0
1526,coke,jacket,crossclassified,1,0,1
1531,child,suit,crossclassified,1,1,0
1494,airplane,wreckage,crossclassified,1,1,0
1493,beach,table,crossclassified,1,0,1
1492,condiment,table,crossclassified,1,0,1
1490,pizza,saps,crossclassified,1,1,0
1487,truck,wreath,crossclassified,1,1,0
1486,scoria,squirrel,crossclassified,1,0,1
1484,toys,woman,crossclassified,1,0,1
1483,car,suitcase,crossclassified,1,1,0
1480,couch,elbow,crossclassified,1,1,0
1478,cake,cornbread,crossclassified,1,1,0
1477,cake,stand,crossclassified,1,1,0
1467,saucepan,spoon,crossclassified,1,0,1
1459,bohemian,woman,crossclassified,1,0,1
1454,cat,sheet,crossclassified,1,1,0
1449,fireplace,vase,crossclassified,1,0,1
1447,fountain,vase,crossclassified,1,0,1
1436,adolescent,child,co-hyponymy,1,0,1
1532,child,outfit,crossclassified,1,1,0
1536,bag,van,crossclassified,1,0,1
1426,bridge,streets,crossclassified,1,1,0
1678,desk,stool,crossclassified,1,1,0
1651,dessert,vase,crossclassified,1,0,1
1652,pastry,vase,crossclassified,1,0,1
1666,playings,woman,crossclassified,1,0,1
1671,lamp,lantern,hypernymy.1,1,1,0
1672,lamp,sidewalk,crossclassified,1,1,0
1673,lamp,van,crossclassified,1,1,0
1684,necktie,suit,crossclassified,1,0,1
1539,pan,stirrer,crossclassified,1,1,0
1698,bridge,unicycle,crossclassified,1,1,0
1709,girl,millennial,crossclassified,1,1,0
1715,graffiti,woman,crossclassified,1,0,1
1718,cow,prop,crossclassified,1,1,0
1735,nothing,train,crossclassified,1,0,1
1738,cover,toilet,crossclassified,1,0,1
1644,curtain,naval,crossclassified,1,1,0
1631,player,skater,crossclassified,1,0,1
1629,couch,cub,crossclassified,1,1,0
1624,giraffe,trafficker,crossclassified,1,1,0
1608,donut,pasty,crossclassified,1,1,0
1603,handle,spoon,crossclassified,1,0,1
1601,frittata,pizza,co-hyponymy,1,0,1
1593,column,train,crossclassified,1,0,1
1590,greybeard,toy,crossclassified,1,0,1
1584,carpet,unknown,crossclassified,1,1,0
1583,bowl,coffee,crossclassified,1,1,0
1580,feather,woman,crossclassified,1,0,1
1573,beer,furniture,crossclassified,1,1,0
1561,mirror,stone,crossclassified,1,1,0
1558,captive,giraffe,crossclassified,1,0,1
1548,bird,vagal,crossclassified,1,1,0
1542,pan,veg,crossclassified,1,1,0
1428,bread,leaf,crossclassified,1,1,0
1422,glass,rolaids,crossclassified,1,1,0
1010,building,manor,hypernymy.1,1,1,0
1171,cub,spoon,crossclassified,1,0,1
1141,tractor,train,crossclassified,1,1,0
1142,machinery,tractor,crossclassified,1,0,1
1148,desk,person,crossclassified,1,1,0
1151,desk,dress,crossclassified,1,1,0
1156,pie,spoon,crossclassified,1,1,0
1157,bed,lounge,crossclassified,1,1,0
1186,fleece,jacket,crossclassified,1,0,1
1239,bench,tunnel,crossclassified,1,1,0
1187,chestnut,horse,hypernymy.2,1,0,1
1191,couch,standing,crossclassified,1,1,0
1198,fruit,tomato,crossclassified,1,1,0
1215,carpet,kitten,crossclassified,1,1,0
1226,bola,bus,crossclassified,1,0,1
1227,bus,light,crossclassified,1,1,0
1138,equipment,tractor,crossclassified,1,0,1
1129,boys,dugout,crossclassified,1,0,1
1106,bicycle,boat,crossclassified,1,0,1
1072,bench,slacks,crossclassified,1,1,0
1062,artist,woman,crossclassified,1,0,1
1061,dress,poor,crossclassified,1,1,0
1060,bird,doll,synonymy,1,1,0
1059,bird,costume,crossclassified,1,1,0
1057,counter,silverware,crossclassified,1,1,0
1054,counter,tininess,crossclassified,1,1,0
1051,bullet,motorcycle,crossclassified,1,0,1
1036,paste,woman,crossclassified,1,0,1
1035,knife,unify,crossclassified,1,1,0
1030,boy,sparkler,crossclassified,1,1,0
1029,bowl,seas,crossclassified,1,1,0
1016,shirt,striped,crossclassified,1,1,0
1011,building,estate,crossclassified,1,1,0
1231,sheep,tie,crossclassified,1,1,0
1242,bench,door,crossclassified,1,1,0
1418,guitar,shirt,crossclassified,1,0,1
1362,house,vase,crossclassified,1,1,0
1348,cape,sheet,crossclassified,1,1,0
1350,cape,woman,crossclassified,1,1,0
1353,cape,drape,crossclassified,1,1,0
1358,cape,robe,crossclassified,1,1,0
1360,bib,cape,crossclassified,1,0,1
1361,cape,cloak,hypernymy.2,1,1,0
1375,serf,surfer,crossclassified,1,0,1
1243,bench,shack,crossclassified,1,1,0
1386,boy,pants,crossclassified,1,1,0
1395,baby,horse,crossclassified,1,0,1
1405,curry,table,crossclassified,1,0,1
1406,base,pizza,crossclassified,1,0,1
1415,cup,floor,crossclassified,1,0,1
1416,floor,sandwich,crossclassified,1,1,0
1347,cape,poncho,co-hyponymy,1,1,0
1346,cape,frock,crossclassified,1,1,0
1343,axletree,boy,crossclassified,1,0,1
1342,boy,cheering,crossclassified,1,1,0
1339,meal,plate,crossclassified,1,0,1
1338,lunch,plate,crossclassified,1,0,1
1334,bag,mouse,crossclassified,1,0,1
1314,refreshment,table,crossclassified,1,0,1
1313,airplane,vane,crossclassified,1,1,0
1311,desk,headphones,crossclassified,1,1,0
1297,ample,pan,crossclassified,1,0,1
1293,female,person,hypernymy.2,1,0,1
1279,bowl,candy,crossclassified,1,1,0
1256,jacket,wrap,hypernymy.2,1,1,0
1246,bench,gazebo,crossclassified,1,1,0
1245,bench,doorway,crossclassified,1,1,0
1244,architecture,bench,crossclassified,1,0,1
2813,plane,thunderbird,crossclassified,1,1,0
2825,traveling,woman,crossclassified,1,0,1
4623,house,ramp,crossclassified,1,1,0
4098,candy,wrapper,crossclassified,1,0,1
4079,man,parka,crossclassified,1,1,0
4080,barbecue,tray,crossclassified,1,0,1
4084,appetizer,tray,crossclassified,1,0,1
4089,case,hat,crossclassified,1,0,1
4091,lower,woman,crossclassified,1,0,1
4095,cup,wrapper,crossclassified,1,0,1
4103,beef,steak,crossclassified,1,0,1
4076,canteen,truck,crossclassified,1,0,1
4104,steak,vegetable,crossclassified,1,1,0
4109,glass,plant,crossclassified,1,0,1
4111,cup,plant,crossclassified,1,0,1
4112,leaves,plant,crossclassified,1,0,1
4113,arrangement,plant,crossclassified,1,0,1
4115,food,plant,crossclassified,1,0,1
4078,man,snow,crossclassified,1,1,0
4073,crust,table,crossclassified,1,0,1
2836,automobile,dog,crossclassified,1,0,1
4046,soup,wantons,crossclassified,1,1,0
4038,carpet,catcher,crossclassified,1,0,1
4039,catcher,tag,crossclassified,1,1,0
4041,scoop,spoon,co-hyponymy,1,0,1
4042,lift,train,crossclassified,1,0,1
4044,courtship,man,crossclassified,1,0,1
4045,cub,soup,crossclassified,1,0,1
4047,food,skillet,crossclassified,1,1,0
4069,mussels,pizza,crossclassified,1,0,1
4052,cat,lynx,hypernymy.1,1,1,0
4054,cat,ocelot,hypernymy.1,1,1,0
4055,cat,tiger,hypernymy.1,1,1,0
4059,advertisements,dugout,crossclassified,1,0,1
4065,bag,refrigerator,crossclassified,1,0,1
4066,hog,motorcycle,crossclassified,1,0,1
4116,jar,plant,crossclassified,1,0,1
4117,floor,roof,co-hyponymy,1,1,0
4119,floor,sheet,crossclassified,1,1,0
4208,person,spoon,crossclassified,1,1,0
4198,building,zoo,crossclassified,1,1,0
4199,backrest,bench,crossclassified,1,0,1
4200,bench,sweater,crossclassified,1,1,0
4202,carrot,hotdog,crossclassified,1,0,1
4203,bench,wog,crossclassified,1,1,0
4206,arms,person,crossclassified,1,0,1
4210,palate,person,crossclassified,1,0,1
4129,dishes,man,crossclassified,1,0,1
4214,entree,salad,crossclassified,1,0,1
4227,kite,ship,crossclassified,1,1,0
4230,starlet,woman,crossclassified,1,0,1
4233,court,train,crossclassified,1,0,1
4234,rocks,table,crossclassified,1,0,1
4235,goggles,woman,crossclassified,1,0,1
4197,building,ranch,crossclassified,1,1,0
4187,port,statue,crossclassified,1,0,1
4182,shoppers,woman,crossclassified,1,0,1
4181,goat,mammal,hypernymy.2,1,1,0
4179,boss,woman,crossclassified,1,0,1
4177,curtain,valence,crossclassified,1,1,0
4175,curtain,hammock,crossclassified,1,1,0
4172,curtain,fabric,crossclassified,1,1,0
4171,giraffe,leg,crossclassified,1,1,0
4161,graphical,shirt,crossclassified,1,0,1
4157,airplane,minicomputer,crossclassified,1,1,0
4149,chicken,table,crossclassified,1,0,1
4146,camel,sheep,crossclassified,1,0,1
4143,bowler,hat,hypernymy.2,1,0,1
4142,neck,woman,crossclassified,1,0,1
4141,fork,vagabond,crossclassified,1,1,0
4138,goofball,man,crossclassified,1,0,1
4036,road,tablecloth,crossclassified,1,0,1
4034,lace,tablecloth,crossclassified,1,0,1
4026,paws,table,crossclassified,1,0,1
3902,cart,trolley,crossclassified,1,1,0
3889,biscuit,scone,co-hyponymy,1,1,0
3892,biscuit,bun,crossclassified,1,1,0
3893,biscuit,burger,crossclassified,1,1,0
3898,cart,shipload,crossclassified,1,1,0
3899,bin,cart,crossclassified,1,0,1
3900,cart,vest,crossclassified,1,1,0
3903,box,cart,crossclassified,1,0,1
3923,poncho,robe,crossclassified,1,0,1
3904,cart,man,crossclassified,1,1,0
3907,burrito,sandwich,crossclassified,1,0,1
3908,vest,waistcoat,synonymy,1,1,0
3912,outfit,vest,crossclassified,1,0,1
3915,cake,tart,crossclassified,1,1,0
3919,dock,plane,crossclassified,1,1,0
3887,biscuit,muffin,co-hyponymy,1,1,0
3883,cake,dolls,crossclassified,1,1,0
3878,pizza,poster,crossclassified,1,1,0
3877,cup,pizza,crossclassified,1,0,1
3876,backpack,pizza,crossclassified,1,0,1
3868,van,windshield,crossclassified,1,1,0
3865,binder,table,crossclassified,1,0,1
3864,boy,teenage,crossclassified,1,1,0
3862,grass,owl,crossclassified,1,0,1
3861,owl,wale,crossclassified,1,1,0
3859,appliances,counter,crossclassified,1,0,1
3855,ampullae,bridge,crossclassified,1,0,1
3853,group,house,hypernymy.1,1,0,1
3851,bulla,motorcycle,crossclassified,1,0,1
3850,barrier,motorcycle,crossclassified,1,0,1
3847,cigarette,shirt,crossclassified,1,0,1
3842,sketchbook,surfer,crossclassified,1,0,1
3921,man,mixer,crossclassified,1,1,0
3926,robe,stone,crossclassified,1,1,0
4024,stereo,table,crossclassified,1,0,1
3985,desk,orange,crossclassified,1,1,0
3969,shirt,toddler,crossclassified,1,1,0
3973,children,shirt,crossclassified,1,0,1
3979,case,refrigerator,crossclassified,1,0,1
3980,refrigerator,shelf,crossclassified,1,1,0
3982,cow,tongue,crossclassified,1,1,0
3984,desk,peel,crossclassified,1,1,0
3988,hat,turbine,crossclassified,1,1,0
3929,jumping,woman,crossclassified,1,0,1
3993,pancake,table,crossclassified,1,0,1
3995,donut,umbellate,crossclassified,1,1,0
4013,bowl,trencher,crossclassified,1,1,0
4014,bowl,cookies,crossclassified,1,1,0
4020,egg,plate,crossclassified,1,1,0
4021,cake,egg,crossclassified,1,0,1
3966,bottle,unknown,crossclassified,1,1,0
3964,gal,woman,hypernymy.2,1,0,1
3962,bread,pickles,crossclassified,1,1,0
3961,plate,snowboarder,crossclassified,1,0,1
3958,delicious,sandwich,crossclassified,1,0,1
3955,man,unknown,crossclassified,1,1,0
3954,man,passenger,crossclassified,1,1,0
3952,creek,water,hypernymy.2,1,0,1
3951,pond,water,hypernymy.2,1,0,1
3948,lake,water,hypernymy.2,1,0,1
3946,brute,fruit,crossclassified,1,0,1
3945,fruit,furtive,crossclassified,1,1,0
3944,fruit,tart,crossclassified,1,1,0
3935,bridge,signs,co-hyponymy,1,1,0
3932,flooding,table,crossclassified,1,0,1
3931,glasses,jacket,crossclassified,1,0,1
3930,motorcycle,rom,crossclassified,1,1,0
4237,swimsuit,woman,crossclassified,1,0,1
4239,jumper,sweatshirt,hypernymy.1,1,0,1
4241,bracelet,sweatshirt,crossclassified,1,0,1
4507,noodles,pizza,crossclassified,1,0,1
4481,arm,plate,crossclassified,1,1,0
4484,bathtub,photo,crossclassified,1,1,0
4496,bathtub,class,crossclassified,1,1,0
4501,goat,sweater,co-hyponymy,1,1,0
4503,goat,person,hypernymy.2,1,1,0
4504,beating,goat,crossclassified,1,0,1
4508,boy,dexter,crossclassified,1,1,0
4524,bathrooms,boy,crossclassified,1,0,1
4511,hut,overhang,crossclassified,1,1,0
4513,hut,water,crossclassified,1,1,0
4516,cottage,hut,crossclassified,1,0,1
4519,beach,hut,crossclassified,1,0,1
4520,hut,trees,crossclassified,1,1,0
4521,boy,looper,crossclassified,1,1,0
4480,arm,sweater,crossclassified,1,1,0
4479,arm,ground,crossclassified,1,1,0
4476,arm,eater,crossclassified,1,1,0
4474,bed,shirted,crossclassified,1,1,0
4471,cake,dag,crossclassified,1,1,0
4470,denim,jacket,crossclassified,1,0,1
4467,hamburger,pizza,crossclassified,1,0,1
4463,jeep,skateboarder,crossclassified,1,1,0
4452,bed,walls,hypernymy.1,1,1,0
4451,box,knife,crossclassified,1,0,1
4442,horse,wall,crossclassified,1,1,0
4439,child,pants,crossclassified,1,1,0
4437,elastic,girl,crossclassified,1,0,1
4436,bottle,knife,crossclassified,1,1,0
4434,atomizer,bottle,crossclassified,1,0,1
4429,leg,zebra,crossclassified,1,0,1
4427,man,spy,crossclassified,1,1,0
4523,boy,lateen,crossclassified,1,1,0
4525,handlebars,jacket,crossclassified,1,0,1
4421,looper,woman,crossclassified,1,0,1
4608,coat,purse,crossclassified,1,0,1
4593,salmon,steak,crossclassified,1,1,0
4594,burger,salmon,crossclassified,1,0,1
4595,plate,salmon,crossclassified,1,0,1
4596,gyro,salad,crossclassified,1,0,1
4605,purse,t-shirt,crossclassified,1,1,0
4607,bag,purse,synonymy,1,0,1
4609,oxen,sheep,crossclassified,1,0,1
4526,jacket,motorbike,crossclassified,1,1,0
4612,collar,vest,crossclassified,1,0,1
4613,guard,vest,crossclassified,1,0,1
4614,leash,vest,crossclassified,1,0,1
4617,donut,waffle,crossclassified,1,0,1
4619,dish,waffle,crossclassified,1,0,1
4622,house,walkway,crossclassified,1,1,0
4592,filet,salmon,crossclassified,1,0,1
4586,bedding,woman,crossclassified,1,0,1
4582,pen,platform,crossclassified,1,1,0
4581,pen,pit,co-hyponymy,1,1,0
4580,cattle,pen,crossclassified,1,0,1
4578,pen,stand,crossclassified,1,1,0
4576,pen,porch,crossclassified,1,1,0
4574,field,pen,crossclassified,1,0,1
4562,house,scarf,crossclassified,1,1,0
4549,motorcycle,parka,crossclassified,1,1,0
4547,dress,oven,crossclassified,1,1,0
4541,dish,soup,hypernymy.1,1,0,1
4538,shirt,tee,crossclassified,1,1,0
4537,person,pillow,crossclassified,1,1,0
4535,person,toddler,hypernymy.1,1,1,0
4533,ghost,man,crossclassified,1,0,1
4531,drink,shirt,crossclassified,1,0,1
4422,potty,woman,crossclassified,1,0,1
4420,res,shirt,crossclassified,1,0,1
4243,bird,rail,hypernymy.1,1,1,0
4332,planter,tub,crossclassified,1,1,0
4318,bacon,meat,hypernymy.2,1,1,0
4321,bacon,pizza,crossclassified,1,1,0
4322,bacon,plate,crossclassified,1,1,0
4324,bacon,cheese,crossclassified,1,1,0
4325,bacon,beef,crossclassified,1,1,0
4326,bacon,condiments,crossclassified,1,1,0
4334,can,planter,crossclassified,1,0,1
4345,receiver,woman,crossclassified,1,0,1
4336,container,planter,hypernymy.1,1,0,1
4338,bath,planter,crossclassified,1,0,1
4339,grass,planter,crossclassified,1,0,1
4340,planter,vat,crossclassified,1,1,0
4341,basin,planter,crossclassified,1,0,1
4342,chef,girl,crossclassified,1,0,1
4311,dancer,man,co-hyponymy,1,0,1
4308,parrot,shirt,crossclassified,1,0,1
4305,animals,carpet,crossclassified,1,0,1
4303,dumbstruck,truck,crossclassified,1,0,1
4302,duck,truck,crossclassified,1,0,1
4296,ice,shirt,crossclassified,1,0,1
4293,car,licentiate,crossclassified,1,1,0
4285,flour,horse,crossclassified,1,0,1
4284,tree,vase,crossclassified,1,0,1
4283,cake,meal,crossclassified,1,1,0
4280,t-shirt,wheelchair,crossclassified,1,0,1
4278,vehicles,wheelchair,crossclassified,1,0,1
4276,boy,reader,crossclassified,1,1,0
4273,dresser,shirt,crossclassified,1,0,1
4262,cow,lion,crossclassified,1,0,1
4254,man,serviceman,synonymy,1,1,0
4245,knife,shears,co-hyponymy,1,1,0
4344,couch,humans,crossclassified,1,1,0
4348,jacket,shower,crossclassified,1,1,0
4419,shirt,suspender,crossclassified,1,1,0
4403,fruit,rode,crossclassified,1,1,0
4386,girl,people,crossclassified,1,1,0
4388,boy,feeder,crossclassified,1,1,0
4390,girl,lamp,crossclassified,1,0,1
4391,lamp,post,crossclassified,1,1,0
4394,lamp,wall,crossclassified,1,1,0
4395,jacket,lamp,crossclassified,1,0,1
4405,backpack,skier,crossclassified,1,0,1
4349,bird,tent,crossclassified,1,1,0
4406,hat,sunhat,hypernymy.1,1,1,0
4411,jacket,walker,crossclassified,1,1,0
4413,grind,table,crossclassified,1,0,1
4415,cup,dress,crossclassified,1,1,0
4417,curtain,food,crossclassified,1,1,0
4418,boy,thread,crossclassified,1,1,0
4385,floor,lobby,co-hyponymy,1,1,0
4384,chairs,floor,crossclassified,1,0,1
4381,bread,hogging,crossclassified,1,1,0
4380,shirt,underwear,crossclassified,1,1,0
4379,knot,tie,co-hyponymy,1,0,1
4378,car,prop,crossclassified,1,1,0
4375,man,partner,co-hyponymy,1,1,0
4370,parser,woman,crossclassified,1,0,1
4369,females,woman,hypernymy.1,1,0,1
4368,dog,doggie,hypernymy.1,1,1,0
4367,carpet,shadow,crossclassified,1,1,0
4364,fur,stove,crossclassified,1,0,1
4363,desk,stove,crossclassified,1,0,1
4360,blacktopping,pizza,crossclassified,1,0,1
4359,girl,twin,crossclassified,1,1,0
4353,polo,skater,crossclassified,1,0,1
4350,awning,bird,crossclassified,1,0,1
3840,omnirange,van,crossclassified,1,0,1
3839,noodles,salad,crossclassified,1,0,1
3834,carpet,couches,crossclassified,1,1,0
3199,man,protester,co-hyponymy,1,1,0
3182,cupcake,sculpture,crossclassified,1,1,0
3186,carpet,court,crossclassified,1,0,1
3190,court,logo,crossclassified,1,1,0
3191,court,t-shirt,crossclassified,1,1,0
3197,bicycle,floor,crossclassified,1,0,1
3198,bike,floor,crossclassified,1,0,1
3201,bowl,eggs,crossclassified,1,1,0
3228,ashtrays,table,crossclassified,1,0,1
3204,bowl,poke,crossclassified,1,1,0
3207,carpet,tool,crossclassified,1,1,0
3209,carpet,controller,crossclassified,1,1,0
3211,carpet,child,crossclassified,1,1,0
3214,carpet,control,crossclassified,1,1,0
3223,bread,toothpick,crossclassified,1,1,0
3181,cupcake,figurine,crossclassified,1,1,0
3175,bird,seed,crossclassified,1,1,0
3170,boat,outrigger,crossclassified,1,1,0
3168,corral,train,crossclassified,1,0,1
3163,carpet,screen,crossclassified,1,1,0
3160,skate,stingray,co-hyponymy,1,0,1
3157,bowl,mangoes,crossclassified,1,1,0
3153,housecoat,shirt,crossclassified,1,0,1
3146,brothers,couch,crossclassified,1,0,1
3143,beautiful,vase,crossclassified,1,0,1
3142,shirt,vehicles,crossclassified,1,1,0
3140,container,tub,hypernymy.1,1,1,0
3138,apple,container,crossclassified,1,0,1
3130,skateboarding,skater,crossclassified,1,0,1
3126,bricks,zebra,crossclassified,1,0,1
3119,donkey,goat,crossclassified,1,0,1
3112,care,chair,crossclassified,1,0,1
3227,shirt,tops,crossclassified,1,1,0
3236,peppers,sandwich,crossclassified,1,0,1
3101,food,slice,crossclassified,1,1,0
3319,shaver,shirt,crossclassified,1,0,1
3305,man,players,co-hyponymy,1,1,0
3307,bread,breadstick,hypernymy.1,1,1,0
3308,skateboarder,sweater,crossclassified,1,1,0
3310,bat,skateboarder,crossclassified,1,0,1
3314,food,heart,hypernymy.1,1,1,0
3315,cake,sweets,crossclassified,1,1,0
3326,fancy,jacket,crossclassified,1,0,1
3237,basin,container,hypernymy.2,1,0,1
3333,flower,restaurant,crossclassified,1,0,1
3336,bed,kitten,crossclassified,1,1,0
3345,bridge,stair,co-hyponymy,1,1,0
3350,couch,donuts,crossclassified,1,1,0
3360,bin,cup,co-hyponymy,1,0,1
3361,rabbit,squirrel,co-hyponymy,1,0,1
3303,battle,cup,crossclassified,1,0,1
3299,post,train,crossclassified,1,0,1
3296,glass,laptop,crossclassified,1,1,0
3294,cat,soap,crossclassified,1,1,0
3293,cat,faucet,crossclassified,1,1,0
3288,coat,hat,crossclassified,1,0,1
3277,man,vacationer,crossclassified,1,1,0
3270,bird,robin,hypernymy.1,1,1,0
3267,burton,woman,crossclassified,1,0,1
3258,counter,saucepan,crossclassified,1,1,0
3251,container,soup,crossclassified,1,0,1
3247,bread,pita,hypernymy.1,1,1,0
3244,container,purifier,crossclassified,1,1,0
3243,container,filter,crossclassified,1,1,0
3240,container,dispenser,hypernymy.1,1,1,0
3239,container,waterpower,crossclassified,1,1,0
3238,container,jug,hypernymy.1,1,1,0
3111,jacket,lapel,crossclassified,1,1,0
3100,eclair,food,hypernymy.2,1,0,1
3368,bagel,croissant,co-hyponymy,1,0,1
2930,couch,statue,crossclassified,1,0,1
2898,cucumber,woman,crossclassified,1,0,1
2914,anchor,man,crossclassified,1,0,1
2915,anchorman,man,crossclassified,1,0,1
2919,jacket,tennis,crossclassified,1,1,0
2928,statue,statues,synonymy,1,1,0
2929,goat,statue,crossclassified,1,0,1
2931,flower,statue,crossclassified,1,0,1
2970,couple,guy,crossclassified,1,1,0
2932,figurine,statue,crossclassified,1,0,1
2943,tent,tray,crossclassified,1,1,0
2944,bowel,tent,crossclassified,1,0,1
2946,kitchen,tent,crossclassified,1,0,1
2947,tarp,tent,crossclassified,1,0,1
2955,cheese,ghee,crossclassified,1,1,0
2896,man,socks,crossclassified,1,1,0
2894,bridge,sand,crossclassified,1,1,0
2890,bridge,stoplight,crossclassified,1,1,0
2884,pot,radish,crossclassified,1,1,0
2883,pot,veg,crossclassified,1,1,0
2882,pot,squash,crossclassified,1,1,0
2873,food,stirrer,crossclassified,1,1,0
2865,footrest,ottoman,synonymy,1,0,1
2864,cushion,ottoman,crossclassified,1,0,1
2862,mobile,ottoman,crossclassified,1,0,1
2859,bridge,gate,crossclassified,1,1,0
2853,desk,rack,crossclassified,1,1,0
2852,cellphones,table,crossclassified,1,0,1
2848,motorcycle,windshields,crossclassified,1,1,0
2842,bear,bench,crossclassified,1,0,1
2841,airplane,outdoors,crossclassified,1,1,0
2838,burger,egg,crossclassified,1,1,0
2958,cheese,jam,crossclassified,1,1,0
2971,couple,glass,crossclassified,1,1,0
3094,fruit,umbrella,crossclassified,1,0,1
3066,comedian,man,crossclassified,1,0,1
3051,cat,top,crossclassified,1,1,0
3052,cat,pipe,crossclassified,1,1,0
3053,basin,cat,crossclassified,1,0,1
3058,bread,jam,crossclassified,1,1,0
3061,bench,snickers,crossclassified,1,1,0
3064,cow,fruit,crossclassified,1,1,0
3068,car,plymouth,crossclassified,1,1,0
2973,featherbedding,woman,crossclassified,1,0,1
3071,pancakes,toast,crossclassified,1,1,0
3073,bun,pancakes,crossclassified,1,0,1
3074,burger,pancakes,crossclassified,1,0,1
3082,bookcase,dresser,co-hyponymy,1,0,1
3083,dresser,shelving,crossclassified,1,1,0
3091,anemone,umbrella,crossclassified,1,0,1
3044,horse,stands,crossclassified,1,1,0
3043,pot,veritable,crossclassified,1,1,0
3042,crackpot,pot,crossclassified,1,0,1
3039,onion,pot,crossclassified,1,0,1
3036,male,surfer,crossclassified,1,0,1
3028,bus,pul,crossclassified,1,1,0
3027,hotdog,slaw,crossclassified,1,1,0
3026,hotdog,noodles,crossclassified,1,1,0
3016,car,faucet,crossclassified,1,1,0
3014,dog,giraffe,crossclassified,1,0,1
3012,bottle,bourbon,crossclassified,1,1,0
3003,headboard,robe,crossclassified,1,0,1
3002,bowl,robe,crossclassified,1,0,1
2997,cycle,door,crossclassified,1,0,1
2989,exhibit,giraffe,crossclassified,1,0,1
2988,bow,dress,crossclassified,1,0,1
2983,lights,motorcycle,crossclassified,1,0,1
3366,domicile,house,hypernymy.1,1,0,1
3369,bun,croissant,hypernymy.1,1,0,1
3833,carpet,lounge,crossclassified,1,1,0
3715,curtain,instrument,crossclassified,1,1,0
3692,cucumber,salad,crossclassified,1,0,1
3701,bowl,feed,crossclassified,1,1,0
3704,bench,chirr,crossclassified,1,1,0
3706,boy,snowsuit,crossclassified,1,1,0
3711,bud,vase,crossclassified,1,0,1
3712,boy,frame,crossclassified,1,1,0
3717,curtain,musicians,crossclassified,1,1,0
3735,boat,dingy,crossclassified,1,1,0
3718,curtain,microphone,crossclassified,1,1,0
3719,curtain,singer,crossclassified,1,1,0
3720,fence,girl,crossclassified,1,0,1
3723,cat,monitor,crossclassified,1,1,0
3724,tops,woman,crossclassified,1,0,1
3728,dress,traveler,crossclassified,1,1,0
3691,hotdog,plat,crossclassified,1,1,0
3687,bangle,couch,crossclassified,1,0,1
3684,dress,female,crossclassified,1,1,0
3683,dress,seat,crossclassified,1,1,0
3680,lunch,soup,crossclassified,1,0,1
3678,africander,bird,crossclassified,1,0,1
3676,building,luggage,crossclassified,1,1,0
3655,door,dugout,crossclassified,1,0,1
3653,goggles,jacket,crossclassified,1,0,1
3651,bathtub,handclasp,crossclassified,1,1,0
3647,curtain,desktop,crossclassified,1,1,0
3646,curtain,keyboard,crossclassified,1,1,0
3644,sticker,truck,crossclassified,1,0,1
3638,girl,snow,crossclassified,1,1,0
3625,camp,tent,crossclassified,1,0,1
3624,taint,tent,crossclassified,1,0,1
3623,animal,girl,crossclassified,1,0,1
3733,jacket,twister,crossclassified,1,1,0
3738,driver,man,crossclassified,1,0,1
3613,garage,person,crossclassified,1,1,0
3804,child,jersey,crossclassified,1,1,0
3788,cake,floor,crossclassified,1,0,1
3793,sari,vase,crossclassified,1,0,1
3794,plane,propellant,crossclassified,1,1,0
3799,bottle,orange,crossclassified,1,1,0
3800,bottle,lemonade,crossclassified,1,1,0
3802,bottle,thermos,hypernymy.1,1,1,0
3806,kitchen,woman,crossclassified,1,0,1
3740,jacket,jeering,crossclassified,1,1,0
3811,frame,window,co-hyponymy,1,0,1
3813,furniture,window,crossclassified,1,0,1
3820,child,grandson,crossclassified,1,1,0
3823,boy,ride,crossclassified,1,1,0
3831,carpet,lobby,crossclassified,1,1,0
3832,carpet,mother,crossclassified,1,1,0
3787,apple,floor,crossclassified,1,0,1
3780,field,wall,crossclassified,1,0,1
3779,belt,wall,crossclassified,1,0,1
3778,baseball,wall,crossclassified,1,0,1
3774,stadium,wall,crossclassified,1,0,1
3773,condiments,sandwich,crossclassified,1,0,1
3766,jumper,skateboarder,crossclassified,1,0,1
3760,cellphone,knife,crossclassified,1,0,1
3758,cat,knife,crossclassified,1,0,1
3753,bird,brain,crossclassified,1,1,0
3749,bowl,mutton,crossclassified,1,1,0
3748,bowl,stirrer,crossclassified,1,1,0
3747,bowl,steak,crossclassified,1,1,0
3746,beef,bowl,crossclassified,1,0,1
3745,man,pol,crossclassified,1,1,0
3744,lover,man,hypernymy.1,1,0,1
3742,pizza,prosciutto,crossclassified,1,1,0
3615,garage,shirt,crossclassified,1,1,0
3612,garage,skater,crossclassified,1,1,0
3370,croissant,pastry,crossclassified,1,1,0
3447,bench,knife,crossclassified,1,1,0
3436,garage,room,crossclassified,1,1,0
3437,family,garage,crossclassified,1,0,1
3438,dog,garage,crossclassified,1,0,1
3439,garage,people,crossclassified,1,1,0
3445,oven,woodcarving,crossclassified,1,1,0
3446,chair,oven,crossclassified,1,0,1
3450,cape,jacket,crossclassified,1,0,1
3474,barrier,floor,crossclassified,1,0,1
3451,jacket,monkey,crossclassified,1,1,0
3454,jacket,jaw,crossclassified,1,1,0
3457,jacket,mirror,crossclassified,1,1,0
3458,face,jacket,crossclassified,1,0,1
3459,bird,jet,crossclassified,1,0,1
3462,child,youth,co-hyponymy,1,1,0
3433,cupcakes,shirt,crossclassified,1,0,1
3432,candle,shirt,crossclassified,1,0,1
3428,cutter,pizza,crossclassified,1,0,1
3426,train,training,crossclassified,1,1,0
3422,earring,shirt,crossclassified,1,0,1
3418,casting,child,crossclassified,1,0,1
3416,coat,trench,crossclassified,1,1,0
3413,screen,woman,crossclassified,1,0,1
3407,couch,jackets,crossclassified,1,1,0
3401,container,counter,crossclassified,1,0,1
3394,chair,sleeveless,crossclassified,1,1,0
3383,mirror,store,crossclassified,1,0,1
3381,camel,llama,co-hyponymy,1,0,1
3380,goat,llama,crossclassified,1,0,1
3374,dress,shorts,crossclassified,1,1,0
3373,dress,scut,crossclassified,1,1,0
3371,crescent,croissant,crossclassified,1,0,1
3473,athlete,pant,crossclassified,1,1,0
3475,floor,post,crossclassified,1,1,0
3600,camera,dress,crossclassified,1,0,1
3575,chicken,pepper,crossclassified,1,1,0
3542,chair,tot,crossclassified,1,1,0
3544,cow,tag,crossclassified,1,1,0
3564,jumper,sweater,synonymy,1,0,1
3566,bun,sweater,crossclassified,1,0,1
3568,plat,sweater,crossclassified,1,0,1
3574,chicken,spice,crossclassified,1,1,0
3576,cheese,chicken,crossclassified,1,0,1
3476,floor,rope,crossclassified,1,1,0
3583,artwork,cake,crossclassified,1,0,1
3586,cat,nickname,crossclassified,1,1,0
3589,cat,porcelain,crossclassified,1,1,0
3591,bite,shirt,crossclassified,1,0,1
3595,food,paganini,crossclassified,1,1,0
3597,grass,plane,crossclassified,1,0,1
3535,benedicts,food,crossclassified,1,0,1
3533,cafe,cup,crossclassified,1,0,1
3529,sandals,woman,crossclassified,1,0,1
3526,bike,boy,crossclassified,1,0,1
3521,barber,woman,crossclassified,1,0,1
3517,bench,torso,crossclassified,1,1,0
3516,bench,hotdogs,crossclassified,1,1,0
3515,bench,chef,crossclassified,1,1,0
3509,apricot,bowl,crossclassified,1,0,1
3502,airplane,artwork,crossclassified,1,1,0
3501,lira,zebra,crossclassified,1,0,1
3500,zebra,zephyr,crossclassified,1,1,0
3497,butter,pizza,crossclassified,1,0,1
3494,fork,toaster,crossclassified,1,1,0
3488,pant,sink,crossclassified,1,0,1
3485,blender,drinks,crossclassified,1,1,0
3483,counter,lamp,co-hyponymy,1,1,0
7245,scatting,woman,crossclassified,1,0,1
7247,chow,dog,hypernymy.2,1,0,1
11335,snowboarder,snowflake,crossclassified,1,1,0
10085,bridge,hole,crossclassified,1,1,0
10075,apple,mango,co-hyponymy,1,1,0
10078,bathtub,woman,crossclassified,1,1,0
10079,build,house,crossclassified,1,0,1
10080,dormer,house,crossclassified,1,0,1
10081,coveralls,jacket,crossclassified,1,0,1
10083,jacket,romper,crossclassified,1,1,0
10086,counter,scissor,crossclassified,1,1,0
10072,cake,lasagna,crossclassified,1,1,0
10088,bed,card,crossclassified,1,1,0
10091,sects,shirt,crossclassified,1,0,1
10092,glows,horse,crossclassified,1,0,1
10093,graffiti,shirt,crossclassified,1,0,1
10094,motorbike,truck,crossclassified,1,0,1
10095,man,usher,crossclassified,1,1,0
10073,skateboarder,student,crossclassified,1,1,0
10071,helmet,truck,crossclassified,1,0,1
10373,bird,bluebird,hypernymy.1,1,1,0
10051,mary,statue,crossclassified,1,0,1
10045,painting,statue,crossclassified,1,0,1
10046,statue,virgin,crossclassified,1,1,0
10047,ornament,statue,crossclassified,1,0,1
10048,portrait,statue,crossclassified,1,0,1
10049,statue,steel,crossclassified,1,1,0
10050,god,statue,crossclassified,1,0,1
10053,fruits,grill,crossclassified,1,0,1
10069,catcher,pat,crossclassified,1,1,0
10059,carpet,field,crossclassified,1,1,0
10060,cake,snack,crossclassified,1,1,0
10061,cake,carrot,crossclassified,1,1,0
10064,bracket,truck,crossclassified,1,0,1
10067,hairtail,shirt,crossclassified,1,0,1
10068,catcher,closes,crossclassified,1,1,0
10096,assistant,man,hypernymy.1,1,0,1
10097,headphone,skateboarder,crossclassified,1,0,1
10098,grill,skateboarder,crossclassified,1,0,1
10151,desk,mat,crossclassified,1,1,0
10136,overcoat,suit,crossclassified,1,0,1
10138,toy,van,crossclassified,1,0,1
10143,bridge,traffic,crossclassified,1,1,0
10146,bungalow,house,hypernymy.2,1,0,1
10148,bus,shirt,crossclassified,1,0,1
10150,pants,snowboarder,crossclassified,1,0,1
10152,beet,cat,crossclassified,1,0,1
10100,ground,road,crossclassified,1,0,1
10153,man,waterside,crossclassified,1,1,0
10155,chair,troll,crossclassified,1,1,0
10156,core,jacket,crossclassified,1,0,1
10157,mick,vase,crossclassified,1,0,1
10158,makeup,vase,crossclassified,1,0,1
10159,passengers,truck,crossclassified,1,0,1
10135,suit,tails,crossclassified,1,1,0
10133,bride,bridge,crossclassified,1,0,1
10128,mirror,shelving,crossclassified,1,1,0
10126,armoire,mirror,crossclassified,1,0,1
10123,headboard,mirror,crossclassified,1,0,1
10119,crape,pizza,crossclassified,1,0,1
10118,dress,headlights,crossclassified,1,1,0
10117,dress,moped,crossclassified,1,1,0
10116,cycle,dress,crossclassified,1,0,1
10112,house,torso,crossclassified,1,1,0
10111,house,player,crossclassified,1,1,0
10110,counter,waterman,crossclassified,1,1,0
10109,shaw,shirt,crossclassified,1,0,1
10106,horse,seat,crossclassified,1,1,0
10104,sandwich,toll,crossclassified,1,1,0
10102,enchilada,food,hypernymy.2,1,0,1
10101,pavement,road,crossclassified,1,0,1
10042,figure,statue,hypernymy.1,1,0,1
10041,outlet,table,crossclassified,1,0,1
10040,featherbedding,girl,crossclassified,1,0,1
9981,boll,vase,crossclassified,1,0,1
9970,awning,house,crossclassified,1,0,1
9974,bookshelf,desert,crossclassified,1,1,0
9976,bookshelf,collection,crossclassified,1,1,0
9978,bathtub,passionflower,crossclassified,1,1,0
9979,goldman,woman,crossclassified,1,0,1
9980,playing,shirt,crossclassified,1,0,1
9982,brownies,cake,hypernymy.2,1,0,1
9991,mexican,table,crossclassified,1,0,1
9983,fruits,shirt,crossclassified,1,0,1
9984,belt,trough,crossclassified,1,0,1
9985,rope,trough,crossclassified,1,0,1
9986,toff,trough,crossclassified,1,0,1
9987,bath,trough,crossclassified,1,0,1
9988,horse,trough,crossclassified,1,0,1
9969,estate,house,crossclassified,1,0,1
9967,bodybuilding,house,crossclassified,1,0,1
9965,house,motorbike,crossclassified,1,1,0
9964,fields,giraffe,crossclassified,1,0,1
9963,jacket,yid,crossclassified,1,1,0
9962,got,jacket,crossclassified,1,0,1
9961,jet,propeller,crossclassified,1,0,1
9959,bed,foot,hypernymy.2,1,1,0
9958,cage,woman,crossclassified,1,0,1
9957,dress,trouser,crossclassified,1,1,0
9954,carpet,kitty,crossclassified,1,1,0
9953,donut,paper,crossclassified,1,1,0
9951,dugout,staircase,crossclassified,1,1,0
9950,dugout,exit,crossclassified,1,1,0
9947,chairs,man,crossclassified,1,0,1
9942,glaze,sauce,crossclassified,1,0,1
9941,garnish,sauce,crossclassified,1,0,1
9989,backpacker,man,crossclassified,1,0,1
9992,desk,tetravalent,crossclassified,1,1,0
10039,handle,pizza,crossclassified,1,0,1
10029,bathtub,cream,crossclassified,1,1,0
10022,house,pizza,crossclassified,1,1,0
10023,house,plate,crossclassified,1,1,0
10024,house,kid,crossclassified,1,1,0
10025,arms,house,crossclassified,1,0,1
10027,chant,woman,crossclassified,1,0,1
10028,bathtub,bread,crossclassified,1,1,0
10030,couch,laptops,crossclassified,1,1,0
9993,train,tribulation,crossclassified,1,1,0
10031,dog,remote,crossclassified,1,1,0
10033,airplane,canyon,crossclassified,1,1,0
10034,airplane,rudder,crossclassified,1,1,0
10036,plow,truck,crossclassified,1,0,1
10037,pizza,pone,crossclassified,1,1,0
10038,napkin,pizza,crossclassified,1,0,1
10020,house,tabletop,crossclassified,1,1,0
10019,bushes,trunk,crossclassified,1,0,1
10018,pole,trunk,crossclassified,1,0,1
10017,courtyard,trunk,crossclassified,1,0,1
10015,trunk,vehicle,crossclassified,1,1,0
10014,tailgate,trunk,crossclassified,1,0,1
10011,coat,snowsuit,co-hyponymy,1,1,0
10007,jacket,tunic,crossclassified,1,1,0
10006,jacket,towel,crossclassified,1,1,0
10003,jacket,masque,crossclassified,1,1,0
10002,bottle,canister,crossclassified,1,1,0
10001,bottle,divisional,crossclassified,1,1,0
9999,bottle,tv,crossclassified,1,1,0
9998,fields,truck,crossclassified,1,0,1
9997,rug,shower,crossclassified,1,1,0
9995,eggs,pizza,crossclassified,1,0,1
9994,blate,pizza,crossclassified,1,0,1
10160,human,truck,crossclassified,1,0,1
10161,hauler,truck,crossclassified,1,0,1
10162,bisque,soup,hypernymy.2,1,0,1
10301,bellow,rug,crossclassified,1,0,1
10292,pager,shirt,crossclassified,1,0,1
10293,kitakyushu,shirt,crossclassified,1,0,1
10294,radio,shirt,crossclassified,1,0,1
10296,banyan,shirt,crossclassified,1,0,1
10297,donut,sugar,crossclassified,1,1,0
10298,skate,skater,crossclassified,1,0,1
10306,board,pavement,crossclassified,1,1,0
10319,desk,dustbin,crossclassified,1,1,0
10311,board,door,crossclassified,1,1,0
10312,board,tarp,crossclassified,1,1,0
10313,board,helmet,crossclassified,1,1,0
10314,arm,board,crossclassified,1,0,1
10316,tankage,woman,crossclassified,1,0,1
10317,cake,cock,crossclassified,1,1,0
10290,claro,shirt,crossclassified,1,0,1
10287,couch,gametophore,crossclassified,1,1,0
10285,cutting,shirt,crossclassified,1,0,1
10282,jam,sandwich,crossclassified,1,0,1
10280,girl,wood,crossclassified,1,1,0
10279,daredevil,skateboarder,crossclassified,1,0,1
10278,bridge,duck,crossclassified,1,1,0
10277,ice,sheep,crossclassified,1,0,1
10275,girl,tv,crossclassified,1,1,0
10274,food,horse,crossclassified,1,0,1
10272,horse,road,crossclassified,1,1,0
10271,bears,curtain,crossclassified,1,0,1
10270,curtain,teddies,crossclassified,1,1,0
10266,skateboarder,skateboarders,synonymy,1,1,0
10265,food,goulash,hypernymy.1,1,1,0
10264,cashew,food,crossclassified,1,0,1
10263,food,nuts,crossclassified,1,1,0
10318,dog,leg,co-hyponymy,1,1,0
10320,horse,pillow,crossclassified,1,1,0
10261,hut,poles,crossclassified,1,1,0
10359,desk,scan,crossclassified,1,1,0
10351,airplane,pen,crossclassified,1,1,0
10352,airplane,person,crossclassified,1,1,0
10353,bench,show,crossclassified,1,1,0
10354,car,men,crossclassified,1,1,0
10355,car,clothing,crossclassified,1,1,0
10356,car,sweatshirt,crossclassified,1,1,0
10361,man,sleeper,crossclassified,1,1,0
10322,horse,ornament,crossclassified,1,1,0
10362,class,jacket,crossclassified,1,0,1
10363,camper,truck,crossclassified,1,0,1
10365,dugout,lutetium,crossclassified,1,1,0
10366,dugout,glows,crossclassified,1,1,0
10367,hotdog,paganini,crossclassified,1,1,0
10369,man,slugger,crossclassified,1,1,0
10350,blender,juicier,crossclassified,1,1,0
10348,lutetium,shirt,crossclassified,1,0,1
10347,family,zebra,crossclassified,1,0,1
10345,cukes,food,hypernymy.2,1,0,1
10344,food,saucer,crossclassified,1,1,0
10343,road,skateboarder,crossclassified,1,0,1
10342,fields,jacket,crossclassified,1,0,1
10341,counter,stonewashed,crossclassified,1,1,0
10339,planter,windowsill,crossclassified,1,1,0
10338,bench,planter,crossclassified,1,0,1
10337,flowerbed,planter,crossclassified,1,0,1
10335,planter,wall,crossclassified,1,1,0
10334,grandpa,shirt,crossclassified,1,0,1
10331,house,toilets,crossclassified,1,1,0
10329,palpation,sink,crossclassified,1,0,1
10327,apple,drop,crossclassified,1,1,0
10323,building,cat,crossclassified,1,1,0
10262,benches,woman,crossclassified,1,0,1
10260,hut,shower,crossclassified,1,1,0
10165,donut,dot,crossclassified,1,1,0
10195,bread,snack,crossclassified,1,1,0
10188,cloth,tent,crossclassified,1,0,1
10190,apple,blate,crossclassified,1,1,0
10191,apple,core,crossclassified,1,1,0
10192,apple,cake,crossclassified,1,1,0
10193,apple,mashers,crossclassified,1,1,0
10194,jacket,snacks,crossclassified,1,1,0
10196,bridge,motorbike,crossclassified,1,1,0
10211,desk,staircase,crossclassified,1,1,0
10199,donuts,pastry,crossclassified,1,1,0
10200,donuts,sweet,crossclassified,1,1,0
10201,man,walkway,crossclassified,1,1,0
10207,bread,chair,crossclassified,1,0,1
10208,chair,veg,crossclassified,1,1,0
10209,check,desk,crossclassified,1,0,1
10187,drapes,tent,crossclassified,1,0,1
10185,bull,trophy,crossclassified,1,1,0
10183,bull,head,crossclassified,1,1,0
10182,bull,wall,crossclassified,1,1,0
10180,girl,sea,crossclassified,1,1,0
10179,boat,lot,crossclassified,1,1,0
10178,boat,checkpoint,crossclassified,1,1,0
10177,boat,lighthouse,crossclassified,1,1,0
10176,boat,cars,crossclassified,1,1,0
10175,carpet,face,crossclassified,1,1,0
10174,jacket,santa,crossclassified,1,1,0
10173,minimization,pan,crossclassified,1,0,1
10172,girl,motorcycle,crossclassified,1,0,1
10171,lady,motorcycle,crossclassified,1,0,1
10169,berets,bird,crossclassified,1,0,1
10167,sandwich,topping,crossclassified,1,1,0
10166,hood,mirror,crossclassified,1,1,0
10210,children,skier,crossclassified,1,0,1
10212,bear,carpet,crossclassified,1,0,1
10259,dwelling,hut,crossclassified,1,0,1
10250,cricket,dugout,crossclassified,1,0,1
10243,elk,moose,synonymy,1,0,1
10244,dear,moose,crossclassified,1,0,1
10245,antelope,moose,crossclassified,1,0,1
10246,morphophoneme,woman,crossclassified,1,0,1
10247,awning,vent,crossclassified,1,0,1
10249,athletes,dugout,crossclassified,1,0,1
10251,cake,skillet,crossclassified,1,1,0
10216,boy,dolls,crossclassified,1,1,0
10252,bowl,fried,crossclassified,1,1,0
10253,appliances,cabinet,crossclassified,1,0,1
10254,man,swing,crossclassified,1,1,0
10255,adult,skier,crossclassified,1,0,1
10256,people,skier,crossclassified,1,0,1
10258,bellow,dog,crossclassified,1,0,1
10242,moose,reindeer,co-hyponymy,1,1,0
10241,dugout,goal,crossclassified,1,1,0
10240,bet,rug,crossclassified,1,0,1
10238,cage,cow,crossclassified,1,0,1
10237,house,siren,crossclassified,1,1,0
10236,firefighter,house,crossclassified,1,0,1
10233,caboodle,dresser,crossclassified,1,0,1
10229,cookie,woman,crossclassified,1,0,1
10228,coat,seat,crossclassified,1,1,0
10227,book,coat,crossclassified,1,0,1
10226,gate,house,crossclassified,1,0,1
10225,batter,male,crossclassified,1,1,0
10224,cow,desert,crossclassified,1,1,0
10222,fork,sanative,crossclassified,1,1,0
10220,adult,boy,hypernymy.1,1,0,1
10218,boy,window,crossclassified,1,1,0
10217,boy,toll,crossclassified,1,1,0
9939,hose,piping,co-hyponymy,1,1,0
9937,bump,hose,crossclassified,1,0,1
9935,horse,soil,crossclassified,1,1,0
9570,burger,chips,crossclassified,1,1,0
9559,cat,placeman,crossclassified,1,1,0
9561,man,slacks,crossclassified,1,1,0
9562,fixing,woman,crossclassified,1,0,1
9564,bat,counter,crossclassified,1,0,1
9566,cylinder,man,crossclassified,1,0,1
9568,cat,curb,crossclassified,1,1,0
9575,poster,train,crossclassified,1,0,1
9594,ground,hose,crossclassified,1,0,1
9576,advertisement,train,crossclassified,1,0,1
9577,leaves,salad,crossclassified,1,0,1
9578,counter,workspace,crossclassified,1,1,0
9579,counter,sneaks,crossclassified,1,1,0
9589,disgusting,pizza,crossclassified,1,0,1
9590,bawl,vase,crossclassified,1,0,1
9558,man,pianist,crossclassified,1,1,0
9555,beer,shirt,crossclassified,1,0,1
9552,roadster,vehicle,hypernymy.2,1,0,1
9546,spotter,woman,crossclassified,1,0,1
9545,chair,restaurant,crossclassified,1,0,1
9540,chair,shoulder,crossclassified,1,1,0
9539,throwing,woman,crossclassified,1,0,1
9538,airplane,rail,crossclassified,1,1,0
9534,desk,paperwork,crossclassified,1,1,0
9533,desk,photograph,crossclassified,1,1,0
9529,cooling,woman,crossclassified,1,0,1
9528,lases,woman,crossclassified,1,0,1
9527,hole,wall,co-hyponymy,1,0,1
9526,glasses,wall,crossclassified,1,0,1
9523,bed,plow,crossclassified,1,1,0
9522,table,thread,crossclassified,1,1,0
9521,rope,table,crossclassified,1,0,1
9593,floor,hose,crossclassified,1,0,1
9596,cement,hose,crossclassified,1,0,1
9519,athlete,dugout,crossclassified,1,0,1
9650,car,tollgate,crossclassified,1,1,0
9638,cukes,donuts,crossclassified,1,0,1
9640,art,cow,crossclassified,1,0,1
9641,artwork,cow,crossclassified,1,0,1
9643,roast,turkey,crossclassified,1,0,1
9644,zeal,zebra,crossclassified,1,0,1
9645,stampede,zebra,crossclassified,1,0,1
9652,giraffe,snout,crossclassified,1,1,0
9599,bottle,dress,crossclassified,1,0,1
9653,broccoli,veritable,crossclassified,1,1,0
9655,cow,doe,co-hyponymy,1,1,0
9658,sink,washerwoman,crossclassified,1,1,0
9659,jag,sink,crossclassified,1,0,1
9663,shelves,sink,crossclassified,1,0,1
9665,pizza,wrap,crossclassified,1,1,0
9637,cake,donuts,hypernymy.1,1,0,1
9636,cupcakes,donuts,crossclassified,1,0,1
9629,coaches,dugout,crossclassified,1,0,1
9628,bowl,goulash,crossclassified,1,1,0
9625,beat,robe,crossclassified,1,0,1
9624,cloth,robe,crossclassified,1,0,1
9620,buggy,building,crossclassified,1,0,1
9619,building,exhibit,crossclassified,1,1,0
9616,couch,shofar,crossclassified,1,1,0
9614,dog,mat,crossclassified,1,1,0
9613,butterfly,ornament,crossclassified,1,1,0
9612,butterfly,dies,crossclassified,1,1,0
9608,bathtub,mirror,crossclassified,1,1,0
9606,bathtub,water,crossclassified,1,1,0
9603,collar,man,crossclassified,1,0,1
9602,brig,cabinet,crossclassified,1,0,1
9600,class,dress,crossclassified,1,0,1
9520,bird,wall,crossclassified,1,1,0
9513,bride,couple,crossclassified,1,0,1
9675,fan,hat,crossclassified,1,0,1
9431,building,trees,crossclassified,1,1,0
9417,cukes,donut,crossclassified,1,0,1
9418,quarterfinal,ramp,crossclassified,1,0,1
9419,ramp,slider,crossclassified,1,1,0
9428,vegetable,veggies,synonymy,1,1,0
9429,skier,stick,crossclassified,1,1,0
9430,building,flowers,crossclassified,1,1,0
9432,building,sunglasses,crossclassified,1,1,0
9447,bed,carpeting,crossclassified,1,1,0
9435,building,people,crossclassified,1,1,0
9437,desk,pillow,crossclassified,1,1,0
9438,desk,ground,crossclassified,1,1,0
9439,airplane,tyre,crossclassified,1,1,0
9440,bowl,chicken,crossclassified,1,1,0
9441,chocolate,shirt,crossclassified,1,0,1
9415,cukes,hotdog,crossclassified,1,0,1
9414,bun,snacks,crossclassified,1,1,0
9413,building,churches,hypernymy.1,1,1,0
9412,building,signpost,crossclassified,1,1,0
9410,bench,clothes,crossclassified,1,1,0
9407,ear,zebra,crossclassified,1,0,1
9406,grass,zebra,crossclassified,1,0,1
9405,boy,pianist,crossclassified,1,1,0
9404,boat,prow,crossclassified,1,1,0
9403,sand,sheep,crossclassified,1,0,1
9402,girl,kittenish,crossclassified,1,1,0
9400,chair,pier,crossclassified,1,0,1
9399,dress,shoulder,crossclassified,1,1,0
9397,pans,stove,crossclassified,1,0,1
9396,knife,stove,crossclassified,1,0,1
9394,table,turkey,crossclassified,1,0,1
9392,jacket,newspaper,crossclassified,1,1,0
9442,door,tailgate,crossclassified,1,1,0
9449,giraffe,leafs,crossclassified,1,1,0
9509,dog,irishwomen,crossclassified,1,1,0
9499,bikini,surfer,crossclassified,1,0,1
9482,donut,sweets,crossclassified,1,1,0
9484,boat,bod,crossclassified,1,1,0
9486,depot,train,crossclassified,1,0,1
9491,counter,cover,crossclassified,1,1,0
9493,cat,water,crossclassified,1,1,0
9498,model,surfer,crossclassified,1,0,1
9500,dickies,shirt,crossclassified,1,0,1
9450,bread,potato,co-hyponymy,1,1,0
9501,photochemistry,soup,crossclassified,1,0,1
9502,bridge,thruway,crossclassified,1,1,0
9505,rock,snow,crossclassified,1,0,1
9506,jump,snow,crossclassified,1,0,1
9507,countenance,snow,crossclassified,1,0,1
9508,couch,video,crossclassified,1,1,0
9481,cup,juicier,crossclassified,1,1,0
9480,cup,filter,crossclassified,1,1,0
9479,cup,vessel,co-hyponymy,1,1,0
9478,cup,funnel,crossclassified,1,1,0
9476,cup,metal,crossclassified,1,1,0
9473,counter,dishwasher,crossclassified,1,1,0
9469,leaf,woman,crossclassified,1,0,1
9468,horse,mat,crossclassified,1,1,0
9467,count,counter,crossclassified,1,0,1
9465,asparagus,counter,crossclassified,1,0,1
9461,horse,workhorse,hypernymy.1,1,1,0
9460,dock,roof,crossclassified,1,1,0
9459,dock,wood,crossclassified,1,1,0
9458,vet,woman,crossclassified,1,0,1
9454,motorcycle,train,crossclassified,1,1,0
9453,hand,suit,crossclassified,1,0,1
9452,mobile,suit,crossclassified,1,0,1
9666,cat,screen,crossclassified,1,1,0
9679,desert,man,crossclassified,1,0,1
9934,counter,pastry,crossclassified,1,1,0
9864,dog,eyes,crossclassified,1,1,0
9855,doll,truck,crossclassified,1,0,1
9856,egg,sauce,crossclassified,1,0,1
9857,sauce,snacks,crossclassified,1,1,0
9859,oil,sauce,crossclassified,1,0,1
9861,salad,woman,crossclassified,1,0,1
9863,dress,turtleneck,crossclassified,1,1,0
9865,bell,donut,crossclassified,1,0,1
9877,flower,lamp,crossclassified,1,0,1
9867,box,donut,crossclassified,1,0,1
9869,meal,shirt,crossclassified,1,0,1
9870,salad,shirt,crossclassified,1,0,1
9871,burglar,pizza,crossclassified,1,0,1
9872,man,torch,crossclassified,1,1,0
9873,popsicle,woman,crossclassified,1,0,1
9854,threepence,truck,crossclassified,1,0,1
9852,photo,table,crossclassified,1,0,1
9851,backside,boy,crossclassified,1,0,1
9850,filling,food,hypernymy.2,1,0,1
9848,food,opening,crossclassified,1,1,0
9847,actor,curtain,crossclassified,1,0,1
9845,shirt,ti,crossclassified,1,1,0
9839,vacationer,woman,crossclassified,1,0,1
9834,dress,grill,crossclassified,1,1,0
9832,boy,photo,crossclassified,1,1,0
9831,ground,shoe,crossclassified,1,1,0
9830,ground,yard,crossclassified,1,1,0
9829,ground,pathway,crossclassified,1,1,0
9821,boy,play,crossclassified,1,1,0
9819,silverware,table,crossclassified,1,0,1
9817,dress,pregnant,crossclassified,1,1,0
9816,belly,dress,crossclassified,1,0,1
9874,adolescent,boy,crossclassified,1,0,1
9878,lamp,tower,crossclassified,1,1,0
9810,raisins,salad,crossclassified,1,0,1
9915,bird,fruit,crossclassified,1,1,0
9906,carpet,shower,crossclassified,1,1,0
9907,child,meter,crossclassified,1,1,0
9908,coleslaw,snakes,crossclassified,1,1,0
9909,coleslaw,snacks,crossclassified,1,1,0
9911,coleslaw,dish,hypernymy.2,1,1,0
9914,lip,table,crossclassified,1,0,1
9916,apple,bird,crossclassified,1,0,1
9879,lamp,topiary,crossclassified,1,1,0
9917,cat,shower,crossclassified,1,1,0
9920,cookie,salad,crossclassified,1,1,0
9921,cookie,sweet,crossclassified,1,1,0
9923,cookie,nuts,crossclassified,1,1,0
9924,cookie,vegetable,crossclassified,1,1,0
9929,cart,counter,crossclassified,1,0,1
9904,couch,gaming,crossclassified,1,1,0
9903,couch,desert,crossclassified,1,1,0
9901,keyboard,knife,crossclassified,1,0,1
9899,boy,light,crossclassified,1,1,0
9897,desk,tv,crossclassified,1,1,0
9896,bowl,hummus,crossclassified,1,1,0
9895,folk,sheep,crossclassified,1,0,1
9891,control,rug,crossclassified,1,0,1
9890,controller,rug,crossclassified,1,0,1
9889,charger,rug,crossclassified,1,0,1
9888,boat,waterfront,crossclassified,1,1,0
9886,bed,ledge,crossclassified,1,1,0
9885,counter,juke,crossclassified,1,1,0
9884,lamppost,train,crossclassified,1,0,1
9882,handbarrow,plane,crossclassified,1,0,1
9881,girl,wrap,crossclassified,1,1,0
9880,christmastide,lamp,crossclassified,1,0,1
9812,benedict,food,crossclassified,1,0,1
9808,child,tetrameter,crossclassified,1,1,0
9682,bunch,curtain,crossclassified,1,0,1
9729,sanative,table,crossclassified,1,0,1
9718,awning,sidewalk,crossclassified,1,1,0
9719,awning,shed,crossclassified,1,1,0
9720,plate,snack,crossclassified,1,1,0
9721,breakfast,plate,crossclassified,1,0,1
9722,dog,kerchief,crossclassified,1,1,0
9727,bathtub,chyles,crossclassified,1,1,0
9732,sweater,tuxedo,crossclassified,1,1,0
9748,desk,divider,crossclassified,1,1,0
9734,sweater,waistcoat,co-hyponymy,1,1,0
9736,child,swing,crossclassified,1,1,0
9738,bed,cub,crossclassified,1,1,0
9740,bed,friends,crossclassified,1,1,0
9742,desk,toys,crossclassified,1,1,0
9744,benches,boat,crossclassified,1,0,1
9717,awning,train,crossclassified,1,1,0
9716,awning,street,crossclassified,1,1,0
9714,awning,tilt,crossclassified,1,1,0
9710,awning,overhead,crossclassified,1,1,0
9706,plate,toilet,crossclassified,1,0,1
9705,goat,got,crossclassified,1,1,0
9704,goat,sand,crossclassified,1,1,0
9699,railing,shoe,crossclassified,1,0,1
9697,adobe,building,crossclassified,1,0,1
9696,bush,elephant,crossclassified,1,0,1
9695,elephant,eye,crossclassified,1,1,0
9693,dog,ground,crossclassified,1,1,0
9691,chair,station,crossclassified,1,1,0
9689,bangles,dress,crossclassified,1,0,1
9688,garage,workshop,crossclassified,1,1,0
9685,curtain,material,crossclassified,1,1,0
9684,brute,curtain,crossclassified,1,0,1
9747,boat,bucket,crossclassified,1,1,0
9750,candy,woman,crossclassified,1,0,1
9807,brushing,child,crossclassified,1,0,1
9792,logs,truck,crossclassified,1,0,1
9785,house,mural,crossclassified,1,1,0
9786,airplane,pizza,crossclassified,1,1,0
9787,bread,stack,crossclassified,1,1,0
9788,child,wall,crossclassified,1,1,0
9790,building,transportation,co-hyponymy,1,1,0
9791,building,buses,crossclassified,1,1,0
9797,giraffe,sky,crossclassified,1,1,0
9752,dress,railing,crossclassified,1,1,0
9799,meal,tray,crossclassified,1,0,1
9800,cloth,horse,crossclassified,1,0,1
9801,banana,brute,crossclassified,1,1,0
9803,man,sport,co-hyponymy,1,1,0
9805,child,pass,crossclassified,1,1,0
9806,blanket,child,crossclassified,1,0,1
9783,boat,wrap,crossclassified,1,1,0
9779,eagle,kiwi,crossclassified,1,1,0
9776,boy,pat,crossclassified,1,1,0
9775,woman,writing,crossclassified,1,1,0
9772,logo,shirt,crossclassified,1,0,1
9771,building,motorcycles,crossclassified,1,1,0
9770,building,warehouse,crossclassified,1,1,0
9769,building,motor,crossclassified,1,1,0
9768,bikes,building,crossclassified,1,0,1
9766,flooding,pizza,crossclassified,1,0,1
9765,secretary,woman,crossclassified,1,0,1
9763,bed,below,crossclassified,1,1,0
9761,belt,coat,crossclassified,1,0,1
9759,horse,stallion,hypernymy.1,1,1,0
9758,bowl,succors,crossclassified,1,1,0
9757,bowl,rises,crossclassified,1,1,0
9753,female,hat,crossclassified,1,0,1
10372,plane,woman,crossclassified,1,0,1
10375,dregs,table,crossclassified,1,0,1
9390,plane,tyre,crossclassified,1,1,0
11025,laptop,wire,crossclassified,1,1,0
11019,limbs,table,crossclassified,1,0,1
11020,plug,table,crossclassified,1,0,1
11021,controls,table,crossclassified,1,0,1
11022,sauce,table,crossclassified,1,0,1
11023,laptop,tie,crossclassified,1,1,0
11024,charger,laptop,crossclassified,1,0,1
11029,computer,wall,crossclassified,1,0,1
11015,bench,bricks,crossclassified,1,1,0
11030,laptop,wall,crossclassified,1,0,1
11032,furniture,wall,crossclassified,1,0,1
11033,poster,wall,crossclassified,1,0,1
11034,chair,wall,crossclassified,1,0,1
11035,papers,wall,crossclassified,1,0,1
11036,airplane,stairs,crossclassified,1,1,0
11018,elbow,table,crossclassified,1,0,1
11012,camera,window,crossclassified,1,1,0
10376,donut,ladder,crossclassified,1,1,0
10993,bowl,granola,crossclassified,1,1,0
10985,cabinet,metal,crossclassified,1,1,0
10986,goose,sea,crossclassified,1,1,0
10987,goose,turkey,co-hyponymy,1,1,0
10988,boat,sofa,crossclassified,1,1,0
10991,boat,dais,crossclassified,1,1,0
10992,boat,ground,crossclassified,1,1,0
10994,bowl,cherries,crossclassified,1,1,0
11011,camera,monitor,crossclassified,1,1,0
10995,bird,choirboy,crossclassified,1,1,0
10997,couch,mirror,crossclassified,1,1,0
11000,boat,rail,crossclassified,1,1,0
11002,butter,table,crossclassified,1,0,1
11008,camera,video,crossclassified,1,1,0
11009,camera,t-shirt,crossclassified,1,1,0
11037,cat,fruits,crossclassified,1,1,0
11039,coffeepot,cup,crossclassified,1,0,1
11040,cubs,cup,crossclassified,1,0,1
11077,tent,wall,crossclassified,1,1,0
11068,jeep,sheep,crossclassified,1,0,1
11070,pig,pole,crossclassified,1,1,0
11071,dog,pig,crossclassified,1,0,1
11072,pig,rodent,crossclassified,1,1,0
11073,cat,pig,crossclassified,1,0,1
11076,door,tent,crossclassified,1,0,1
11078,canvas,tent,hypernymy.2,1,0,1
11041,cup,ice,crossclassified,1,1,0
11079,blank,tent,crossclassified,1,0,1
11081,bounding,house,crossclassified,1,0,1
11083,bookshelf,peak,crossclassified,1,1,0
11087,hoof,horse,crossclassified,1,0,1
11094,dugout,tie,crossclassified,1,1,0
11095,dugout,weal,crossclassified,1,1,0
11067,couch,tub,crossclassified,1,1,0
11066,couch,leg,crossclassified,1,1,0
11065,bathtub,tiles,crossclassified,1,1,0
11063,bathtub,kitchen,crossclassified,1,1,0
11062,featherbedding,toy,crossclassified,1,0,1
11061,board,keyboard,crossclassified,1,0,1
11060,keyboard,pants,crossclassified,1,1,0
11059,computer,keyboard,crossclassified,1,0,1
11058,keyboard,legs,crossclassified,1,1,0
11051,bread,cat,crossclassified,1,0,1
11050,cat,doughnuts,crossclassified,1,1,0
11049,cat,sandwich,crossclassified,1,1,0
11047,dresser,shelves,crossclassified,1,1,0
11045,sand,truck,crossclassified,1,0,1
11044,table,trays,crossclassified,1,1,0
11043,heart,vase,crossclassified,1,0,1
11042,calf,horse,crossclassified,1,0,1
10984,boat,rack,crossclassified,1,1,0
10983,counterirritants,sink,crossclassified,1,0,1
10982,counter,waste,crossclassified,1,1,0
10917,cherries,couch,crossclassified,1,0,1
10905,banana,ends,crossclassified,1,1,0
10908,curtain,leading,crossclassified,1,1,0
10911,bench,sirs,crossclassified,1,1,0
10912,cloths,surfer,crossclassified,1,0,1
10913,pony,zebra,crossclassified,1,0,1
10915,curtain,jeans,crossclassified,1,1,0
10918,couch,tomato,crossclassified,1,1,0
10934,bystander,man,crossclassified,1,0,1
10920,cat,sandal,crossclassified,1,1,0
10921,dixie,glass,crossclassified,1,0,1
10922,glass,shake,crossclassified,1,1,0
10924,glass,mixer,crossclassified,1,1,0
10927,figurine,horse,crossclassified,1,0,1
10928,horse,lamp,crossclassified,1,1,0
10904,banana,sign,crossclassified,1,1,0
10901,banana,scale,crossclassified,1,1,0
10898,boat,kayaking,crossclassified,1,1,0
10897,sheep,torso,crossclassified,1,1,0
10896,sheep,sofa,crossclassified,1,1,0
10895,sheep,sheepskin,crossclassified,1,1,0
10894,bridge,cyclical,crossclassified,1,1,0
10893,bridge,chair,crossclassified,1,1,0
10892,giraffe,paper,crossclassified,1,1,0
10891,giraffe,repair,crossclassified,1,1,0
10888,car,gemara,crossclassified,1,1,0
10887,automobile,carpet,crossclassified,1,0,1
10886,carpet,lablab,crossclassified,1,1,0
10884,beguiling,building,crossclassified,1,0,1
10883,stain,train,crossclassified,1,0,1
10881,bathtub,tie,crossclassified,1,1,0
10880,airplane,fence,crossclassified,1,1,0
10933,counter,pruritus,crossclassified,1,1,0
10936,judge,man,crossclassified,1,0,1
10981,carter,counter,crossclassified,1,0,1
10971,cloths,man,crossclassified,1,0,1
10960,appliances,cabinets,crossclassified,1,0,1
10962,counter,monitor,crossclassified,1,1,0
10963,computer,counter,crossclassified,1,0,1
10964,bostonian,dog,crossclassified,1,0,1
10968,condominium,house,co-hyponymy,1,0,1
10969,house,planet,crossclassified,1,1,0
10972,giraffe,window,crossclassified,1,1,0
10938,boat,floor,crossclassified,1,1,0
10973,furniture,horse,crossclassified,1,0,1
10974,curtain,steel,crossclassified,1,1,0
10975,chutney,spoon,crossclassified,1,0,1
10978,juice,spoon,crossclassified,1,0,1
10979,souse,spoon,crossclassified,1,0,1
10980,counter,maker,crossclassified,1,1,0
10959,cabinetry,cabinets,crossclassified,1,0,1
10958,cabinets,rack,crossclassified,1,1,0
10956,bathtub,knob,crossclassified,1,1,0
10955,bathtub,person,crossclassified,1,1,0
10954,bathtub,leiden,crossclassified,1,1,0
10953,banister,bench,crossclassified,1,0,1
10952,bench,leaf,crossclassified,1,1,0
10951,cheer,curtain,crossclassified,1,0,1
10950,countertop,island,crossclassified,1,0,1
10949,dining,island,crossclassified,1,0,1
10946,gate,tree,crossclassified,1,0,1
10945,fence,tree,crossclassified,1,0,1
10944,siding,tree,crossclassified,1,0,1
10943,t-shirt,tree,crossclassified,1,0,1
10942,steel,tree,crossclassified,1,0,1
10941,pole,tree,crossclassified,1,0,1
10940,shirt,tree,crossclassified,1,0,1
11096,dugout,stone,crossclassified,1,1,0
11099,mischief,woman,crossclassified,1,0,1
11103,bridge,taches,crossclassified,1,1,0
11261,dirt,horse,crossclassified,1,0,1
11253,fork,meal,crossclassified,1,1,0
11254,crocodile,fork,crossclassified,1,0,1
11256,sea,skier,crossclassified,1,0,1
11257,cat,furniture,crossclassified,1,1,0
11259,forest,horse,crossclassified,1,0,1
11260,cave,horse,crossclassified,1,0,1
11262,chair,cheese,crossclassified,1,1,0
11276,snowboarder,table,crossclassified,1,1,0
11263,costume,motorcycle,crossclassified,1,0,1
11264,knife,tang,crossclassified,1,1,0
11269,blender,chopper,crossclassified,1,1,0
11270,blender,can,crossclassified,1,1,0
11271,shooting,woman,crossclassified,1,0,1
11273,steel,zebra,crossclassified,1,0,1
11251,lettuce,pickles,crossclassified,1,1,0
11250,lettuce,veggies,hypernymy.2,1,1,0
11248,baby,toothbrush,crossclassified,1,1,0
11247,baby,toothbrushes,crossclassified,1,1,0
11244,airplane,nose,crossclassified,1,1,0
11243,cloth,sheep,crossclassified,1,0,1
11242,cover,sheep,crossclassified,1,0,1
11241,fabric,sheep,crossclassified,1,0,1
11240,cape,sheep,crossclassified,1,0,1
11239,truck,wrecker,hypernymy.1,1,1,0
11238,desk,shirts,crossclassified,1,1,0
11236,bridge,cellphone,crossclassified,1,1,0
11234,bench,telescope,crossclassified,1,1,0
11233,bench,portfolio,crossclassified,1,1,0
11232,bench,canisters,crossclassified,1,1,0
11231,bench,package,crossclassified,1,1,0
11229,bench,containers,crossclassified,1,1,0
11274,bottle,spoon,co-hyponymy,1,0,1
11277,jumpsuit,snowboarder,crossclassified,1,0,1
11224,bouquet,flowers,crossclassified,1,0,1
11322,joker,man,crossclassified,1,0,1
11313,counter,gold,crossclassified,1,1,0
11316,counter,desktop,crossclassified,1,1,0
11317,bracelet,counter,crossclassified,1,0,1
11318,cat,flowerpot,crossclassified,1,1,0
11319,house,kites,crossclassified,1,1,0
11321,player,sock,crossclassified,1,1,0
11323,desk,plug,crossclassified,1,1,0
11279,meat,potatoes,crossclassified,1,1,0
11325,dugout,train,crossclassified,1,1,0
11327,booting,skyline,crossclassified,1,0,1
11331,bowl,russet,crossclassified,1,1,0
11332,blackcap,car,crossclassified,1,0,1
11333,car,couch,crossclassified,1,1,0
11334,bathtub,wakashan,crossclassified,1,1,0
11310,bus,glass,crossclassified,1,1,0
11309,adolescent,skateboarder,crossclassified,1,0,1
11308,horse,steel,crossclassified,1,1,0
11306,player,sportsman,crossclassified,1,1,0
11305,tiles,tub,crossclassified,1,0,1
11303,counter,sausage,crossclassified,1,1,0
11302,counter,lobsters,crossclassified,1,1,0
11299,sofa,vase,crossclassified,1,0,1
11297,cushion,vase,crossclassified,1,0,1
11295,house,lawn,crossclassified,1,1,0
11294,grass,house,crossclassified,1,0,1
11287,cellphone,curtain,crossclassified,1,0,1
11285,carpet,foot,crossclassified,1,1,0
11284,leg,table,crossclassified,1,0,1
11283,duo,table,crossclassified,1,0,1
11282,skirt,table,crossclassified,1,0,1
11281,meat,salad,crossclassified,1,1,0
11226,flowers,glass,crossclassified,1,1,0
11223,flowers,jar,crossclassified,1,1,0
11104,blackcap,truck,crossclassified,1,0,1
11148,counter,steel,crossclassified,1,1,0
11138,doorway,shelf,crossclassified,1,1,0
11142,doorway,storage,crossclassified,1,1,0
11143,doorway,interior,crossclassified,1,1,0
11144,doorway,entry,hypernymy.2,1,1,0
11145,bowl,car,crossclassified,1,0,1
11146,car,food,crossclassified,1,1,0
11151,skateboarder,train,crossclassified,1,1,0
11162,coffee,plate,crossclassified,1,1,0
11153,building,veranda,crossclassified,1,1,0
11155,outdoor,train,crossclassified,1,0,1
11156,man,tenniel,crossclassified,1,1,0
11157,lettuce,man,crossclassified,1,0,1
11158,car,showroom,crossclassified,1,1,0
11159,car,electronic,crossclassified,1,1,0
11136,doorway,tie,crossclassified,1,1,0
11135,doorway,t-shirt,crossclassified,1,1,0
11134,doorway,pant,crossclassified,1,1,0
11133,doorway,screen,crossclassified,1,1,0
11132,doorway,rack,crossclassified,1,1,0
11131,boat,clothing,crossclassified,1,1,0
11128,boat,chip,crossclassified,1,1,0
11127,bed,gurney,crossclassified,1,1,0
11124,counter,plat,crossclassified,1,1,0
11120,kite,toys,hypernymy.2,1,1,0
11117,kite,ta,crossclassified,1,1,0
11116,man,watermelon,crossclassified,1,1,0
11114,grill,plate,crossclassified,1,1,0
11113,notebooks,table,crossclassified,1,0,1
11110,bench,greathearted,crossclassified,1,1,0
11108,cat,self,crossclassified,1,1,0
11107,ac,cat,crossclassified,1,0,1
11161,coffee,foods,hypernymy.2,1,1,0
11163,cappuccino,coffee,hypernymy.2,1,0,1
11222,flowers,tree,crossclassified,1,1,0
11212,kicker,man,crossclassified,1,0,1
11205,giraffe,vehicles,crossclassified,1,1,0
11206,redcap,truck,crossclassified,1,0,1
11207,bed,bedfellow,crossclassified,1,1,0
11208,bed,kids,crossclassified,1,1,0
11209,cow,shadow,crossclassified,1,1,0
11210,bottle,wood,crossclassified,1,1,0
11214,bench,knee,crossclassified,1,1,0
11164,beverage,coffee,hypernymy.1,1,0,1
11216,bowl,dresser,crossclassified,1,0,1
11217,credenza,dresser,crossclassified,1,0,1
11218,blender,mischief,crossclassified,1,1,0
11219,desk,draw,crossclassified,1,1,0
11220,boy,teddy,crossclassified,1,1,0
11221,flowers,pot,crossclassified,1,1,0
11204,horse,horsing,crossclassified,1,1,0
11203,chair,doorway,crossclassified,1,1,0
11201,chair,screen,crossclassified,1,1,0
11197,bench,rocker,crossclassified,1,1,0
11194,bird,mallard,hypernymy.1,1,1,0
11193,house,nameplate,crossclassified,1,1,0
11192,certain,house,crossclassified,1,0,1
11189,giraffe,zipper,crossclassified,1,1,0
11188,disc,man,crossclassified,1,0,1
11183,route,truck,crossclassified,1,0,1
11181,children,man,co-hyponymy,1,0,1
11180,man,relatives,co-hyponymy,1,1,0
11177,bed,coverlet,crossclassified,1,1,0
11174,table,wing,crossclassified,1,1,0
11172,bird,biscuit,crossclassified,1,1,0
11171,beach,boy,crossclassified,1,0,1
11165,cream,cup,crossclassified,1,0,1
10878,samara,skier,crossclassified,1,0,1
10877,bed,befog,crossclassified,1,1,0
10876,glabrous,woman,crossclassified,1,0,1
10535,net,zebra,crossclassified,1,0,1
10527,iron,tracks,crossclassified,1,0,1
10529,drink,kitten,crossclassified,1,0,1
10530,bottle,kitten,crossclassified,1,0,1
10531,animal,kitten,hypernymy.1,1,0,1
10533,measure,table,crossclassified,1,0,1
10534,ice,table,crossclassified,1,0,1
10536,cage,zebra,crossclassified,1,0,1
10549,finished,table,crossclassified,1,0,1
10537,armrest,couch,crossclassified,1,0,1
10538,couch,knob,crossclassified,1,1,0
10541,inflatable,pig,crossclassified,1,0,1
10545,ampullae,woman,crossclassified,1,0,1
10546,bun,cukes,crossclassified,1,1,0
10547,fur,rug,crossclassified,1,0,1
10525,ground,tracks,crossclassified,1,0,1
10524,cyclist,statue,crossclassified,1,0,1
10523,manikin,statue,crossclassified,1,0,1
10522,mannequin,statue,crossclassified,1,0,1
10521,bike,statue,crossclassified,1,0,1
10519,inflatable,statue,crossclassified,1,0,1
10516,cover,horse,crossclassified,1,0,1
10514,skateboarder,wood,crossclassified,1,1,0
10513,show,skateboarder,crossclassified,1,0,1
10512,roof,skateboarder,crossclassified,1,0,1
10510,flower,lily,crossclassified,1,1,0
10509,flower,jag,crossclassified,1,1,0
10508,flower,fulani,crossclassified,1,1,0
10507,flower,leaves,crossclassified,1,1,0
10506,tent,toy,crossclassified,1,1,0
10504,bored,man,crossclassified,1,0,1
10503,finger,knife,crossclassified,1,0,1
10548,boat,lamp,crossclassified,1,1,0
10551,couch,friends,crossclassified,1,1,0
10501,vehicles,woman,crossclassified,1,0,1
10597,kettle,window,crossclassified,1,1,0
10585,button,desk,crossclassified,1,0,1
10586,flower,salad,crossclassified,1,0,1
10587,collar,dress,crossclassified,1,1,0
10592,book,t-shirt,crossclassified,1,1,0
10593,book,laptop,crossclassified,1,1,0
10594,board,book,crossclassified,1,0,1
10598,cupboard,kettle,crossclassified,1,0,1
10552,rope,skier,crossclassified,1,0,1
10599,kettle,mischief,crossclassified,1,1,0
10604,hotpot,kettle,crossclassified,1,0,1
10605,container,kettle,hypernymy.1,1,0,1
10606,kettle,machine,crossclassified,1,1,0
10607,coffee,kettle,crossclassified,1,0,1
10608,shorts,surfer,crossclassified,1,0,1
10584,jacket,mime,crossclassified,1,1,0
10582,building,fade,crossclassified,1,1,0
10580,chinese,food,crossclassified,1,0,1
10578,bird,birdie,synonymy,1,1,0
10577,bird,sticks,crossclassified,1,1,0
10576,giraffe,mountain,crossclassified,1,1,0
10575,furniture,melon,crossclassified,1,0,1
10572,melon,squash,crossclassified,1,1,0
10571,melon,pumpkin,crossclassified,1,1,0
10566,bed,traveler,crossclassified,1,1,0
10565,counter,stow,crossclassified,1,1,0
10564,counter,kine,crossclassified,1,1,0
10562,cat,computer,crossclassified,1,1,0
10558,beads,woman,crossclassified,1,0,1
10557,telephone,woman,crossclassified,1,0,1
10556,dessert,shirt,crossclassified,1,0,1
10553,skier,water,crossclassified,1,1,0
10502,shirt,tankage,crossclassified,1,1,0
10500,cat,desktop,crossclassified,1,1,0
10610,table,welding,crossclassified,1,1,0
10420,dog,owl,crossclassified,1,1,0
10410,pan,spatula,crossclassified,1,0,1
10411,ladle,spatula,crossclassified,1,0,1
10412,pasta,spatula,crossclassified,1,0,1
10413,broccoli,spatula,crossclassified,1,0,1
10415,cs,desk,crossclassified,1,0,1
10418,fields,woman,crossclassified,1,0,1
10421,pottery,woman,crossclassified,1,0,1
10433,travelers,woman,crossclassified,1,0,1
10425,pastry,shirt,crossclassified,1,0,1
10426,pretzel,shirt,crossclassified,1,0,1
10427,car,plane,crossclassified,1,0,1
10428,secession,woman,crossclassified,1,0,1
10430,cheeseburger,sandwich,hypernymy.2,1,0,1
10431,lutetium,man,crossclassified,1,0,1
10409,car,motorbike,crossclassified,1,1,0
10406,bed,ice,crossclassified,1,1,0
10405,carpet,strap,crossclassified,1,1,0
10404,carpet,elbow,crossclassified,1,1,0
10403,chine,shirt,crossclassified,1,0,1
10401,boat,titanic,crossclassified,1,1,0
10398,bench,turtleneck,crossclassified,1,1,0
10397,bench,sweet,crossclassified,1,1,0
10393,cheese,croissant,crossclassified,1,0,1
10392,croissant,snack,crossclassified,1,1,0
10391,cake,croissant,crossclassified,1,0,1
10389,desert,woman,crossclassified,1,0,1
10387,button,mouse,crossclassified,1,0,1
10383,peel,spoon,crossclassified,1,0,1
10382,fruit,spoon,crossclassified,1,0,1
10381,snack,spoon,crossclassified,1,0,1
10379,scaffolding,table,crossclassified,1,0,1
10432,cat,fruit,crossclassified,1,1,0
10434,tourists,woman,crossclassified,1,0,1
10496,food,paper,crossclassified,1,1,0
10485,bowl,enter,crossclassified,1,1,0
10474,chair,desert,crossclassified,1,1,0
10475,chair,shophar,crossclassified,1,1,0
10476,chair,human,crossclassified,1,1,0
10477,chair,drummer,crossclassified,1,1,0
10479,bowl,veritable,crossclassified,1,1,0
10480,cake,rose,crossclassified,1,1,0
10487,god,tie,crossclassified,1,0,1
10435,child,soil,crossclassified,1,1,0
10488,building,town,crossclassified,1,1,0
10490,building,factory,crossclassified,1,1,0
10492,building,spire,crossclassified,1,1,0
10493,bed,grate,crossclassified,1,1,0
10494,lamp,train,crossclassified,1,0,1
10495,counter,croissant,crossclassified,1,1,0
10471,bird,clay,crossclassified,1,1,0
10467,bench,blanket,crossclassified,1,0,1
10461,boy,morphophoneme,crossclassified,1,1,0
10460,carpet,restaurant,crossclassified,1,1,0
10459,jacket,polo,crossclassified,1,1,0
10458,ducky,toy,crossclassified,1,0,1
10457,figurine,toy,crossclassified,1,0,1
10456,suicide,toy,crossclassified,1,0,1
10455,figure,toy,crossclassified,1,0,1
10451,catcher,glows,crossclassified,1,1,0
10450,stone,zebra,crossclassified,1,0,1
10449,cake,t-shirt,crossclassified,1,1,0
10447,rug,trunk,crossclassified,1,1,0
10443,keyboardist,man,crossclassified,1,0,1
10438,class,windshield,crossclassified,1,0,1
10437,bowl,grapevines,crossclassified,1,1,0
10436,bowl,yogurt,crossclassified,1,1,0
10609,surfer,thread,crossclassified,1,1,0
10614,fairing,motorcycle,crossclassified,1,0,1
10875,cheep,truck,crossclassified,1,0,1
10787,kitchen,sink,crossclassified,1,1,0
10777,bridge,metal,crossclassified,1,1,0
10778,bridge,truss,crossclassified,1,1,0
10779,bridge,porch,co-hyponymy,1,1,0
10781,biscuit,cat,crossclassified,1,0,1
10782,cat,unclear,crossclassified,1,1,0
10784,carpet,controllership,crossclassified,1,1,0
10788,cupboard,kitchen,crossclassified,1,0,1
10801,t-shirt,wheel,crossclassified,1,0,1
10789,kitchen,shelving,crossclassified,1,1,0
10791,kitchen,self,crossclassified,1,1,0
10793,grass,top,crossclassified,1,1,0
10794,floor,grass,crossclassified,1,0,1
10796,grass,yard,crossclassified,1,1,0
10798,car,pushpin,crossclassified,1,1,0
10772,counter,flowers,crossclassified,1,0,1
10771,flowers,sender,crossclassified,1,1,0
10769,flowers,shelves,crossclassified,1,1,0
10767,careerism,woman,crossclassified,1,0,1
10766,device,remote,hypernymy.1,1,1,0
10765,device,unsporting,crossclassified,1,1,0
10764,charger,device,hypernymy.2,1,0,1
10763,device,electronic,crossclassified,1,1,0
10760,device,reader,crossclassified,1,1,0
10757,device,table,crossclassified,1,1,0
10755,bridge,canal,crossclassified,1,1,0
10753,machine,motorcycle,co-hyponymy,1,0,1
10752,board,motorcycle,crossclassified,1,0,1
10751,counter,homemaker,crossclassified,1,1,0
10750,island,wall,crossclassified,1,0,1
10749,halfpennyworth,wall,crossclassified,1,0,1
10748,countertop,wall,crossclassified,1,0,1
10800,bank,dog,crossclassified,1,0,1
10803,vehicle,wheel,hypernymy.1,1,0,1
10746,book,sofa,crossclassified,1,0,1
10862,sheep,shoe,crossclassified,1,1,0
10842,airplane,glass,crossclassified,1,1,0
10846,building,pot,crossclassified,1,1,0
10849,hydroplane,train,crossclassified,1,0,1
10850,monitor,train,crossclassified,1,0,1
10856,leaf,pot,crossclassified,1,0,1
10860,bug,dog,crossclassified,1,0,1
10863,champagne,man,crossclassified,1,0,1
10804,covering,wheel,crossclassified,1,0,1
10865,bibliothecas,motorcycle,crossclassified,1,0,1
10866,table,tamarisk,crossclassified,1,1,0
10867,succors,table,crossclassified,1,0,1
10870,homesteader,sink,crossclassified,1,0,1
10871,bedding,couch,crossclassified,1,0,1
10872,couch,towel,crossclassified,1,1,0
10841,glasses,person,crossclassified,1,0,1
10840,person,smile,crossclassified,1,1,0
10836,man,reflection,crossclassified,1,1,0
10835,licentiate,motorcycle,crossclassified,1,0,1
10834,desk,tray,crossclassified,1,1,0
10827,table,wheel,crossclassified,1,1,0
10826,bed,tablecloth,crossclassified,1,1,0
10825,handle,truck,crossclassified,1,0,1
10824,boots,truck,crossclassified,1,0,1
10822,grass,person,hypernymy.2,1,1,0
10821,grass,outfield,crossclassified,1,1,0
10816,bridge,mat,crossclassified,1,1,0
10815,car,pickup,crossclassified,1,1,0
10809,tarp,wheel,crossclassified,1,0,1
10808,stage,wheel,crossclassified,1,0,1
10807,parachute,wheel,crossclassified,1,0,1
10806,motorbike,wheel,crossclassified,1,0,1
10747,cupboard,wall,crossclassified,1,0,1
10745,mealtime,table,crossclassified,1,0,1
10620,skateboarder,watch,crossclassified,1,1,0
10670,airplane,shoe,crossclassified,1,1,0
10660,kid,shoe,crossclassified,1,0,1
10661,applesauce,cup,crossclassified,1,0,1
10663,cup,saucer,crossclassified,1,1,0
10666,dog,train,crossclassified,1,1,0
10668,bed,pillowcase,crossclassified,1,1,0
10669,chair,sirs,crossclassified,1,1,0
10671,airplane,pilot,crossclassified,1,1,0
10682,chicken,cock,hypernymy.1,1,1,0
10673,curtain,lath,crossclassified,1,1,0
10674,counter,door,crossclassified,1,1,0
10675,steel,woman,crossclassified,1,0,1
10676,lovers,woman,crossclassified,1,0,1
10677,cup,desktop,crossclassified,1,1,0
10678,cup,monitor,crossclassified,1,1,0
10658,bench,cot,crossclassified,1,1,0
10652,sink,steel,crossclassified,1,1,0
10650,bird,gel,crossclassified,1,1,0
10649,dam,train,crossclassified,1,0,1
10643,cabinets,machine,crossclassified,1,1,0
10642,cabinets,kitchenette,crossclassified,1,1,0
10641,cabinets,kitchenettes,crossclassified,1,1,0
10638,cabinets,tile,crossclassified,1,1,0
10635,recliner,remote,crossclassified,1,0,1
10633,armchair,remote,crossclassified,1,0,1
10632,remote,t-shirt,crossclassified,1,1,0
10630,steel,train,crossclassified,1,0,1
10629,skate,snow,crossclassified,1,0,1
10628,playground,snow,crossclassified,1,0,1
10625,snow,t-shirt,crossclassified,1,1,0
10623,car,corolla,crossclassified,1,1,0
10621,contestant,skateboarder,hypernymy.1,1,0,1
10680,chicken,plant,crossclassified,1,1,0
10684,mirror,rug,crossclassified,1,0,1
10740,anchor,boat,crossclassified,1,0,1
10727,cup,upholder,crossclassified,1,1,0
10719,controllership,toilet,crossclassified,1,0,1
10720,table,toilet,crossclassified,1,0,1
10721,marble,toilet,crossclassified,1,0,1
10722,remote,toilet,crossclassified,1,0,1
10723,tala,toilet,crossclassified,1,0,1
10725,cup,hook,crossclassified,1,1,0
10728,bridge,span,synonymy,1,1,0
10686,couch,orange,crossclassified,1,1,0
10731,cloth,surfer,crossclassified,1,0,1
10733,car,cauterant,crossclassified,1,1,0
10734,car,machination,crossclassified,1,1,0
10736,desk,water,crossclassified,1,1,0
10737,cat,lounge,crossclassified,1,1,0
10738,cat,linens,crossclassified,1,1,0
10717,lindane,toilet,crossclassified,1,0,1
10716,bath,toilet,co-hyponymy,1,0,1
10715,bed,tell,crossclassified,1,1,0
10714,beach,bed,crossclassified,1,0,1
10713,desk,equipment,crossclassified,1,1,0
10709,bird,fork,crossclassified,1,1,0
10708,bird,plat,crossclassified,1,1,0
10707,sniper,woman,crossclassified,1,0,1
10706,shooter,woman,crossclassified,1,0,1
10705,marksman,woman,crossclassified,1,0,1
10704,airplane,vase,crossclassified,1,0,1
10703,top,vase,crossclassified,1,0,1
10702,pop,soda,synonymy,1,0,1
10700,juice,soda,crossclassified,1,0,1
10695,cabinet,ta,crossclassified,1,1,0
10692,bed,tables,crossclassified,1,1,0
10689,automobiles,car,synonymy,1,0,1
9391,animals,cat,hypernymy.1,1,0,1
9389,bans,cat,crossclassified,1,0,1
7248,cover,hotdog,crossclassified,1,0,1
8042,pan,taw,crossclassified,1,1,0
8022,girl,van,crossclassified,1,0,1
8026,farmhouse,house,hypernymy.2,1,0,1
8030,cabinets,handle,crossclassified,1,1,0
8035,cow,pitcher,crossclassified,1,1,0
8038,food,onions,hypernymy.1,1,1,0
8040,cabinet,desktop,crossclassified,1,1,0
8043,fun,pan,crossclassified,1,0,1
8019,earring,pizza,crossclassified,1,0,1
8045,omelette,pan,crossclassified,1,0,1
8046,cake,loaf,crossclassified,1,1,0
8047,bench,bus,crossclassified,1,1,0
8048,horse,human,crossclassified,1,1,0
8049,chair,shelving,crossclassified,1,1,0
8051,cake,nut,co-hyponymy,1,1,0
8020,carrot,van,crossclassified,1,0,1
8018,bathrobe,jacket,crossclassified,1,0,1
8395,cup,dustbin,crossclassified,1,1,0
8003,child,wooden,crossclassified,1,1,0
7996,shirt,sucker,crossclassified,1,1,0
7997,bridge,numberplate,crossclassified,1,1,0
7998,bridge,sealing,crossclassified,1,1,0
7999,child,coke,crossclassified,1,1,0
8001,child,vest,crossclassified,1,1,0
8002,child,tomato,crossclassified,1,1,0
8004,shirt,snowboard,crossclassified,1,1,0
8017,child,cow,crossclassified,1,0,1
8008,counter,dish,crossclassified,1,1,0
8009,counter,horse,crossclassified,1,1,0
8012,horse,pitcher,crossclassified,1,1,0
8014,light,sidecar,crossclassified,1,0,1
8015,car,sidecar,crossclassified,1,0,1
8016,boy,sidecar,crossclassified,1,0,1
8054,bug,butterfly,crossclassified,1,0,1
8058,headgear,helmet,hypernymy.1,1,0,1
8059,bed,bedpost,crossclassified,1,1,0
8111,boy,brushing,crossclassified,1,1,0
8101,concrete,pizza,crossclassified,1,0,1
8102,pizza,sidewalk,crossclassified,1,1,0
8103,pizza,tail,crossclassified,1,1,0
8104,pigeons,pizza,crossclassified,1,0,1
8106,girl,shorts,crossclassified,1,1,0
8110,pasha,pizza,crossclassified,1,0,1
8113,arm,cabinet,crossclassified,1,0,1
8061,rice,snacks,crossclassified,1,1,0
8116,cabinet,shoulder,crossclassified,1,1,0
8118,cheese,jacket,crossclassified,1,0,1
8120,rig,truck,hypernymy.2,1,0,1
8122,save,vase,crossclassified,1,0,1
8123,citrus,fruit,hypernymy.2,1,0,1
8125,boys,house,crossclassified,1,0,1
8099,pizza,tile,crossclassified,1,1,0
8098,floor,pizza,crossclassified,1,0,1
8095,ceiling,vent,crossclassified,1,0,1
8094,metal,vent,crossclassified,1,0,1
8089,gripe,zebra,crossclassified,1,0,1
8086,bowl,nut,crossclassified,1,1,0
8084,fun,shirt,crossclassified,1,0,1
8081,box,train,crossclassified,1,0,1
8077,champion,woman,crossclassified,1,0,1
8076,olympian,woman,crossclassified,1,0,1
8075,food,seasonings,hypernymy.1,1,1,0
8074,mat,woman,crossclassified,1,0,1
8070,cabbage,leaf,crossclassified,1,1,0
8068,cabbage,onion,crossclassified,1,1,0
8067,cabbage,cauliflower,co-hyponymy,1,1,0
8066,table,tremor,crossclassified,1,1,0
8065,control,man,crossclassified,1,0,1
7994,fizzes,pizza,crossclassified,1,0,1
7993,photo,woman,crossclassified,1,0,1
7992,window,woman,crossclassified,1,0,1
7908,class,suit,crossclassified,1,0,1
7898,building,photograph,crossclassified,1,1,0
7899,bed,building,crossclassified,1,0,1
7900,company,man,crossclassified,1,0,1
7905,bench,harness,crossclassified,1,1,0
7906,man,tire,crossclassified,1,1,0
7907,man,unicyclist,crossclassified,1,1,0
7909,ball,vase,crossclassified,1,0,1
7925,cat,whisker,crossclassified,1,1,0
7910,toy,vase,crossclassified,1,0,1
7911,belt,vase,crossclassified,1,0,1
7913,car,crash,crossclassified,1,1,0
7915,bun,tomato,crossclassified,1,1,0
7920,shirt,waiter,crossclassified,1,1,0
7923,building,river,crossclassified,1,1,0
7896,building,photo,crossclassified,1,1,0
7894,building,portrait,crossclassified,1,1,0
7886,juice,wine,crossclassified,1,0,1
7885,liquid,wine,hypernymy.1,1,0,1
7883,carding,helmet,crossclassified,1,0,1
7882,bench,setback,crossclassified,1,1,0
7881,battle,bench,crossclassified,1,0,1
7880,bench,can,crossclassified,1,1,0
7879,man,steps,crossclassified,1,1,0
7877,chimney,vase,crossclassified,1,0,1
7871,desk,doughnuts,crossclassified,1,1,0
7869,person,playing,crossclassified,1,1,0
7863,plant,train,crossclassified,1,0,1
7862,shed,train,crossclassified,1,0,1
7861,bear,bottle,crossclassified,1,0,1
7860,headlight,hood,crossclassified,1,0,1
7856,bathtub,westernization,crossclassified,1,1,0
7924,sugar,table,crossclassified,1,0,1
7929,motorcycle,statue,crossclassified,1,1,0
7991,wallpaper,woman,crossclassified,1,0,1
7970,animal,field,crossclassified,1,0,1
7958,bus,helmet,crossclassified,1,1,0
7960,man,nab,crossclassified,1,1,0
7966,field,hill,crossclassified,1,1,0
7967,field,land,hypernymy.1,1,1,0
7968,field,meadow,crossclassified,1,1,0
7969,field,steppe,hypernymy.1,1,1,0
7971,cowboys,field,crossclassified,1,0,1
7930,airplane,chair,crossclassified,1,0,1
7976,cuisine,pizza,crossclassified,1,0,1
7978,decorator,man,crossclassified,1,0,1
7979,man,teenagers,crossclassified,1,1,0
7982,pizza,potato,crossclassified,1,1,0
7985,girl,snoop,crossclassified,1,1,0
7990,cardigan,woman,crossclassified,1,0,1
7957,bus,card,crossclassified,1,1,0
7956,conductor,train,crossclassified,1,0,1
7955,airplane,coat,crossclassified,1,1,0
7954,airplane,wooden,crossclassified,1,1,0
7952,house,loft,crossclassified,1,1,0
7949,cables,desk,crossclassified,1,0,1
7948,couch,track,crossclassified,1,1,0
7947,chair,stack,crossclassified,1,1,0
7945,cake,sand,crossclassified,1,1,0
7944,cake,leaf,crossclassified,1,1,0
7941,ring,tent,crossclassified,1,0,1
7938,raincoat,woman,crossclassified,1,0,1
7936,cpu,desk,crossclassified,1,0,1
7935,coat,collar,crossclassified,1,1,0
7934,coat,uniform,crossclassified,1,1,0
7933,airplane,bed,crossclassified,1,0,1
7931,boat,char,crossclassified,1,1,0
8126,dikes,man,crossclassified,1,0,1
8127,board,toilet,crossclassified,1,0,1
8130,hotdog,wooden,crossclassified,1,1,0
8302,horse,shoes,crossclassified,1,1,0
8291,castle,stone,crossclassified,1,1,0
8293,castle,wall,crossclassified,1,1,0
8294,castle,fortress,crossclassified,1,1,0
8297,building,lamp,crossclassified,1,1,0
8299,horse,track,crossclassified,1,1,0
8301,grass,horse,crossclassified,1,0,1
8305,counter,dishpan,crossclassified,1,1,0
8318,coat,ski,crossclassified,1,1,0
8306,pen,tie,crossclassified,1,0,1
8308,butter,donut,crossclassified,1,0,1
8309,flag,woman,crossclassified,1,0,1
8310,can,container,hypernymy.2,1,1,0
8312,giraffe,steel,crossclassified,1,1,0
8316,boat,women,crossclassified,1,1,0
8290,castle,structure,hypernymy.2,1,1,0
8289,broccoli,greens,crossclassified,1,1,0
8288,broccoli,dish,crossclassified,1,1,0
8285,bench,field,crossclassified,1,1,0
8283,dress,ground,crossclassified,1,1,0
8282,dress,heir,crossclassified,1,1,0
8278,carpet,ladder,crossclassified,1,1,0
8276,hotdog,meal,crossclassified,1,1,0
8274,dish,hotdog,hypernymy.1,1,0,1
8273,hotdog,tissue,crossclassified,1,1,0
8272,hotdog,wrapping,crossclassified,1,1,0
8270,hotdog,tray,crossclassified,1,1,0
8268,cabinet,console,synonymy,1,1,0
8267,pig,sheep,crossclassified,1,0,1
8266,cake,photo,crossclassified,1,1,0
8263,floor,machine,crossclassified,1,1,0
8262,floor,unknown,crossclassified,1,1,0
8317,coat,gloves,crossclassified,1,1,0
8319,coat,skateboard,crossclassified,1,1,0
8259,floor,games,crossclassified,1,1,0
8370,grains,rice,hypernymy.1,1,0,1
8360,boy,goalkeeper,crossclassified,1,1,0
8361,cowl,woman,crossclassified,1,0,1
8362,tunic,woman,crossclassified,1,0,1
8364,garment,woman,crossclassified,1,0,1
8365,man,thirst,crossclassified,1,1,0
8366,carpet,paw,crossclassified,1,1,0
8374,hairtail,man,crossclassified,1,0,1
8321,dress,wedding,crossclassified,1,1,0
8380,burger,lettuce,crossclassified,1,0,1
8381,lettuce,pizza,crossclassified,1,1,0
8386,lounge,woman,crossclassified,1,0,1
8387,jacket,stand,crossclassified,1,1,0
8388,jacket,machine,crossclassified,1,1,0
8391,hydroplane,wing,crossclassified,1,0,1
8358,boy,gate,crossclassified,1,1,0
8357,counter,juicer,crossclassified,1,1,0
8355,bathtub,handle,crossclassified,1,1,0
8354,cow,grill,crossclassified,1,1,0
8352,pizza,tie,crossclassified,1,0,1
8351,eel,plane,crossclassified,1,0,1
8347,system,woman,crossclassified,1,0,1
8345,cat,wooded,crossclassified,1,1,0
8344,dog,shorts,crossclassified,1,1,0
8337,charger,curtain,crossclassified,1,0,1
8334,dog,keyboard,crossclassified,1,1,0
8333,listener,woman,crossclassified,1,0,1
8331,bolt,chair,crossclassified,1,0,1
8330,bench,human,crossclassified,1,1,0
8329,grill,shirt,crossclassified,1,0,1
8328,dress,umbrella,crossclassified,1,1,0
8324,bench,elders,crossclassified,1,1,0
8260,floor,light,crossclassified,1,1,0
8258,burglar,hotdog,crossclassified,1,0,1
8131,man,showboat,crossclassified,1,1,0
8175,dress,tap,crossclassified,1,1,0
8166,bookshelves,shelf,hypernymy.2,1,0,1
8167,shirt,tattoo,crossclassified,1,1,0
8168,angry,bridge,crossclassified,1,0,1
8169,collar,desk,crossclassified,1,0,1
8170,desk,leash,crossclassified,1,1,0
8173,helmet,train,crossclassified,1,0,1
8176,blender,wooden,crossclassified,1,1,0
8190,dessert,pastry,crossclassified,1,1,0
8178,blender,equipment,crossclassified,1,1,0
8179,blender,warmer,crossclassified,1,1,0
8182,girl,pyjamas,crossclassified,1,1,0
8184,beach,wing,crossclassified,1,0,1
8185,pole,wing,crossclassified,1,0,1
8187,snow,wing,crossclassified,1,0,1
8162,cow,road,crossclassified,1,1,0
8161,tongue,woman,crossclassified,1,0,1
8158,building,toque,crossclassified,1,1,0
8157,woman,zombie,crossclassified,1,1,0
8156,goofy,woman,crossclassified,1,0,1
8155,art,curtain,crossclassified,1,0,1
8153,curtain,kite,crossclassified,1,1,0
8151,dog,doggo,crossclassified,1,1,0
8149,picture,shirt,crossclassified,1,0,1
8148,bench,footboard,crossclassified,1,1,0
8146,bench,got,crossclassified,1,1,0
8145,bridge,tunnels,crossclassified,1,1,0
8142,donut,pole,crossclassified,1,1,0
8136,man,thrower,co-hyponymy,1,1,0
8135,board,carpet,crossclassified,1,0,1
8134,carpet,knee,crossclassified,1,1,0
8133,beech,house,crossclassified,1,0,1
8188,curtain,dowel,crossclassified,1,1,0
8192,dessert,frosting,crossclassified,1,1,0
8253,boat,hat,crossclassified,1,1,0
8237,ballplayer,woman,crossclassified,1,0,1
8230,omelette,taco,co-hyponymy,1,0,1
8231,snakes,taco,crossclassified,1,0,1
8232,boy,yahoo,crossclassified,1,1,0
8233,ski,woman,crossclassified,1,0,1
8234,pan,soup,crossclassified,1,0,1
8235,bridge,leaf,crossclassified,1,1,0
8242,overpass,truck,crossclassified,1,0,1
8193,line,lion,crossclassified,1,0,1
8245,sopranino,woman,crossclassified,1,0,1
8246,bade,man,crossclassified,1,0,1
8247,bet,man,crossclassified,1,0,1
8248,strap,table,crossclassified,1,0,1
8250,flat,table,crossclassified,1,0,1
8251,bake,table,crossclassified,1,0,1
8227,plate,taco,crossclassified,1,0,1
8225,kite,vehicle,crossclassified,1,1,0
8224,kite,wing,crossclassified,1,1,0
8223,jaguar,lion,co-hyponymy,1,0,1
8221,lion,tree,crossclassified,1,1,0
8220,cougar,lion,crossclassified,1,0,1
8218,surfer,table,crossclassified,1,0,1
8215,handle,woman,crossclassified,1,0,1
8213,hunt,roof,crossclassified,1,0,1
8212,handle,roof,crossclassified,1,0,1
8211,roof,structure,crossclassified,1,1,0
8206,bird,grill,crossclassified,1,1,0
8204,guest,man,crossclassified,1,0,1
8203,racketeering,shirt,crossclassified,1,0,1
8198,lei,woman,crossclassified,1,0,1
8196,food,leaf,crossclassified,1,1,0
8194,brick,car,crossclassified,1,0,1
7850,cup,robe,crossclassified,1,0,1
7841,girl,watch,crossclassified,1,1,0
7840,girl,snowboard,crossclassified,1,1,0
7447,brute,table,crossclassified,1,0,1
7438,roll,table,crossclassified,1,0,1
7439,shuttlecock,woman,crossclassified,1,0,1
7441,desk,keyboardist,crossclassified,1,1,0
7443,bowl,stiffening,crossclassified,1,1,0
7444,bowl,proud,crossclassified,1,1,0
7446,pastries,table,crossclassified,1,0,1
7449,food,spoonful,crossclassified,1,1,0
7467,booth,wooden,crossclassified,1,1,0
7451,food,spun,crossclassified,1,1,0
7452,dress,tissue,crossclassified,1,1,0
7455,chandelier,vase,crossclassified,1,0,1
7457,decanter,vase,crossclassified,1,0,1
7458,crystal,vase,crossclassified,1,0,1
7460,poster,woman,crossclassified,1,0,1
7436,bull,hoof,crossclassified,1,1,0
7429,fork,onion,crossclassified,1,1,0
7428,fork,paid,crossclassified,1,1,0
7422,bagel,gaggle,crossclassified,1,1,0
7421,bed,pad,crossclassified,1,1,0
7420,battleship,ship,hypernymy.2,1,0,1
7419,ship,vessel,hypernymy.2,1,1,0
7418,helmet,ship,crossclassified,1,0,1
7417,hat,ship,crossclassified,1,0,1
7416,jacket,ship,crossclassified,1,0,1
7415,cap,ship,crossclassified,1,0,1
7411,giraffe,guy,crossclassified,1,1,0
7410,bottles,table,crossclassified,1,0,1
7408,refreshments,table,crossclassified,1,0,1
7406,bridge,shelter,co-hyponymy,1,1,0
7402,carpet,clothing,crossclassified,1,1,0
7399,rider,van,crossclassified,1,0,1
7461,advertisement,woman,crossclassified,1,0,1
7468,booth,tree,crossclassified,1,1,0
7394,elephant,foliage,crossclassified,1,1,0
7521,bookshelf,pillow,crossclassified,1,1,0
7507,electronics,pitcher,crossclassified,1,0,1
7512,building,class,co-hyponymy,1,1,0
7514,louse,man,crossclassified,1,0,1
7517,automobile,bird,crossclassified,1,0,1
7518,bird,wheel,crossclassified,1,1,0
7520,bookshelf,photograph,crossclassified,1,1,0
7524,chair,leather,crossclassified,1,1,0
7469,booth,house,crossclassified,1,1,0
7525,sanctioning,skier,crossclassified,1,0,1
7528,kail,lettuce,crossclassified,1,0,1
7529,lettuce,produce,hypernymy.2,1,1,0
7538,chest,door,crossclassified,1,0,1
7541,armor,door,crossclassified,1,0,1
7542,cheese,cup,crossclassified,1,0,1
7505,bottle,pitcher,co-hyponymy,1,0,1
7504,container,pitcher,hypernymy.1,1,0,1
7503,juicer,pitcher,crossclassified,1,0,1
7501,food,glass,co-hyponymy,1,0,1
7500,glass,horse,crossclassified,1,1,0
7496,house,toaster,crossclassified,1,1,0
7494,voter,woman,crossclassified,1,0,1
7493,nightshirt,skier,crossclassified,1,0,1
7492,chair,tray,crossclassified,1,1,0
7491,backboard,chair,crossclassified,1,0,1
7482,food,meals,hypernymy.1,1,1,0
7481,ham,pizza,crossclassified,1,0,1
7480,brute,salad,crossclassified,1,0,1
7479,mushroom,salad,crossclassified,1,0,1
7475,horse,wire,crossclassified,1,1,0
7474,battle,bottle,crossclassified,1,0,1
7473,bottle,cutlery,crossclassified,1,1,0
7397,cabinet,cloth,crossclassified,1,1,0
7392,elephant,tub,crossclassified,1,1,0
7549,bate,table,crossclassified,1,0,1
7297,bird,branch,crossclassified,1,1,0
7285,fruit,peach,hypernymy.1,1,1,0
7286,cream,shirt,crossclassified,1,0,1
7287,jitney,truck,crossclassified,1,0,1
7293,skater,tent,crossclassified,1,0,1
7294,nut,sandwich,crossclassified,1,0,1
7295,fedora,woman,crossclassified,1,0,1
7302,cake,fudge,crossclassified,1,1,0
7317,jacket,military,crossclassified,1,1,0
7307,sauce,vegetable,crossclassified,1,1,0
7308,horse,ship,crossclassified,1,1,0
7310,canopy,cloth,hypernymy.2,1,1,0
7312,canopy,pole,crossclassified,1,1,0
7313,canopy,cover,co-hyponymy,1,1,0
7314,canopy,cape,crossclassified,1,1,0
7284,fruit,peaches,hypernymy.1,1,1,0
7279,knife,sword,co-hyponymy,1,1,0
7278,bench,distinguishable,crossclassified,1,1,0
7277,ferry,ship,crossclassified,1,0,1
7275,bucket,cow,crossclassified,1,0,1
7274,pasta,sandwich,crossclassified,1,0,1
7273,counter,wok,crossclassified,1,0,1
7271,skillet,wok,co-hyponymy,1,0,1
7269,bird,owe,crossclassified,1,1,0
7268,kitten,woman,crossclassified,1,0,1
7266,bed,gamer,crossclassified,1,1,0
7264,bed,hat,crossclassified,1,1,0
7262,animal,peacock,hypernymy.1,1,0,1
7259,bowl,doll,crossclassified,1,1,0
7258,bowl,pail,co-hyponymy,1,1,0
7251,girl,mirror,crossclassified,1,1,0
7249,bench,sheep,crossclassified,1,0,1
7315,canopy,home,crossclassified,1,1,0
7320,girl,torso,crossclassified,1,1,0
7391,elephant,leaf,crossclassified,1,1,0
7374,roll,sandwich,crossclassified,1,0,1
7363,boat,drum,crossclassified,1,1,0
7367,flower,mirror,crossclassified,1,0,1
7368,mirror,wooden,crossclassified,1,1,0
7370,furniture,mirror,crossclassified,1,0,1
7371,jug,mirror,crossclassified,1,0,1
7372,doorway,mirror,crossclassified,1,0,1
7376,bell,horse,crossclassified,1,0,1
7322,counter,shampoo,crossclassified,1,1,0
7378,man,rabbi,crossclassified,1,1,0
7379,jewish,man,crossclassified,1,0,1
7383,americanization,food,crossclassified,1,0,1
7384,bole,bridge,crossclassified,1,0,1
7386,soup,tomato,crossclassified,1,1,0
7389,man,trey,crossclassified,1,1,0
7356,bad,man,crossclassified,1,0,1
7355,cake,towel,crossclassified,1,1,0
7353,coffeepot,table,crossclassified,1,0,1
7351,dinghy,raft,crossclassified,1,0,1
7350,raft,water,crossclassified,1,1,0
7349,jacket,raft,crossclassified,1,0,1
7347,pole,raft,crossclassified,1,0,1
7344,autostrada,food,crossclassified,1,0,1
7343,scrub,skateboarder,crossclassified,1,0,1
7341,athlete,fence,crossclassified,1,0,1
7340,fence,t-shirt,crossclassified,1,1,0
7338,fence,human,crossclassified,1,1,0
7334,house,rack,crossclassified,1,1,0
7331,cups,glasses,co-hyponymy,1,0,1
7329,cabin,desk,crossclassified,1,0,1
7324,grinder,sandwich,hypernymy.2,1,0,1
7323,counter,toiletries,crossclassified,1,1,0
7544,belle,train,crossclassified,1,0,1
7552,doorstep,table,crossclassified,1,0,1
7836,airplane,horizon,crossclassified,1,1,0
7745,dog,steel,crossclassified,1,1,0
7739,shirt,tishri,crossclassified,1,1,0
7740,man,sink,crossclassified,1,1,0
7741,drag,man,crossclassified,1,0,1
7742,lipstick,man,crossclassified,1,0,1
7743,fag,man,crossclassified,1,0,1
7744,brush,dog,crossclassified,1,0,1
7748,plush,shirt,crossclassified,1,0,1
7768,goatfish,man,crossclassified,1,0,1
7757,blanket,coat,crossclassified,1,1,0
7759,bedding,blanket,hypernymy.1,1,0,1
7760,blanket,fabric,crossclassified,1,1,0
7762,cow,gnu,crossclassified,1,1,0
7764,jeep,train,crossclassified,1,1,0
7765,close,shirt,crossclassified,1,0,1
7734,cucumber,fork,crossclassified,1,0,1
7732,housekeeper,woman,crossclassified,1,0,1
7728,bag,truck,crossclassified,1,0,1
7725,jacket,luggage,crossclassified,1,1,0
7722,crust,sandwich,crossclassified,1,0,1
7721,man,tablecloth,crossclassified,1,1,0
7720,dinner,man,crossclassified,1,0,1
7719,car,sheet,crossclassified,1,1,0
7714,arms,woman,crossclassified,1,0,1
7711,bird,fish,crossclassified,1,1,0
7710,boy,plants,crossclassified,1,1,0
7707,bed,drinks,crossclassified,1,1,0
7706,bed,use,crossclassified,1,1,0
7705,shirt,whitethroat,crossclassified,1,1,0
7702,machine,pot,crossclassified,1,0,1
7701,cauldron,pot,hypernymy.2,1,0,1
7696,drum,pot,co-hyponymy,1,0,1
7766,bezant,sandwich,crossclassified,1,0,1
7769,man,tuxedo,crossclassified,1,1,0
7694,man,nut,crossclassified,1,1,0
7825,barer,quesadilla,crossclassified,1,0,1
7811,couch,pet,crossclassified,1,1,0
7815,cat,joystick,crossclassified,1,1,0
7816,bottle,shoe,crossclassified,1,1,0
7818,cow,nose,crossclassified,1,1,0
7821,jacket,shrift,crossclassified,1,1,0
7822,shrift,woman,crossclassified,1,0,1
7826,cheese,quesadilla,crossclassified,1,0,1
7770,cat,tap,crossclassified,1,1,0
7827,pita,quesadilla,crossclassified,1,0,1
7828,pie,quesadilla,crossclassified,1,0,1
7829,quesadilla,wrap,crossclassified,1,1,0
7831,boy,cow,crossclassified,1,0,1
7832,jacket,photographer,crossclassified,1,1,0
7834,hat,scissor,crossclassified,1,1,0
7809,bench,paws,crossclassified,1,1,0
7803,cow,decor,crossclassified,1,1,0
7802,cow,television,crossclassified,1,1,0
7801,cow,decoration,crossclassified,1,1,0
7800,house,sunglasses,crossclassified,1,1,0
7795,man,purse,crossclassified,1,1,0
7794,car,zip,crossclassified,1,1,0
7792,goose,waterbird,hypernymy.2,1,1,0
7785,hand,sandwich,crossclassified,1,0,1
7783,house,numberplate,crossclassified,1,1,0
7780,desk,pad,crossclassified,1,1,0
7778,cow,pul,crossclassified,1,1,0
7777,crematorium,food,crossclassified,1,0,1
7776,eyebrows,hat,crossclassified,1,0,1
7775,carrot,hat,crossclassified,1,0,1
7773,pant,shoe,crossclassified,1,0,1
7771,train,wino,crossclassified,1,1,0
7695,rug,sink,crossclassified,1,1,0
7693,girl,hand,crossclassified,1,1,0
7553,honey,table,crossclassified,1,0,1
7601,cushion,sweater,crossclassified,1,0,1
7592,skater,snow,crossclassified,1,0,1
7594,mirror,plane,crossclassified,1,0,1
7596,bathtub,tree,crossclassified,1,1,0
7597,bathtub,board,crossclassified,1,1,0
7599,kiss,woman,crossclassified,1,0,1
7600,kissing,woman,crossclassified,1,0,1
7604,bad,catcher,crossclassified,1,0,1
7625,couch,wheel,crossclassified,1,1,0
7605,hut,wood,crossclassified,1,1,0
7606,hut,wooden,crossclassified,1,1,0
7611,sand,table,crossclassified,1,0,1
7615,fleece,sheep,crossclassified,1,0,1
7616,body,sheep,crossclassified,1,0,1
7617,indian,woman,crossclassified,1,0,1
7590,cap,snow,crossclassified,1,0,1
7588,ground,snow,crossclassified,1,0,1
7585,snow,trail,crossclassified,1,1,0
7582,pul,shirt,crossclassified,1,0,1
7581,car,try,crossclassified,1,1,0
7580,sauce,sauerkraut,crossclassified,1,1,0
7578,pale,sauce,crossclassified,1,0,1
7573,corvette,woman,crossclassified,1,0,1
7571,dog,paper,crossclassified,1,1,0
7570,cake,nuts,co-hyponymy,1,1,0
7568,barrel,trough,crossclassified,1,0,1
7566,container,trough,hypernymy.1,1,0,1
7564,basin,trough,co-hyponymy,1,0,1
7560,glaze,shirt,crossclassified,1,0,1
7559,cat,dish,co-hyponymy,1,1,0
7556,bathtub,shirt,crossclassified,1,0,1
7555,cover,woman,crossclassified,1,0,1
7619,cream,man,crossclassified,1,0,1
7632,cat,hair,crossclassified,1,1,0
7692,girl,paper,crossclassified,1,1,0
7676,net,player,crossclassified,1,0,1
7661,glass,glassware,hypernymy.2,1,1,0
7662,possessions,table,crossclassified,1,0,1
7663,cables,table,crossclassified,1,0,1
7666,bagel,top,crossclassified,1,1,0
7669,eyeglass,hat,crossclassified,1,0,1
7670,hat,looking,crossclassified,1,1,0
7677,hat,player,crossclassified,1,0,1
7633,skier,sportsman,co-hyponymy,1,1,0
7680,scientist,woman,crossclassified,1,0,1
7683,snowboard,woman,crossclassified,1,0,1
7684,showboat,woman,crossclassified,1,0,1
7686,bathtub,pillow,crossclassified,1,1,0
7688,bathtub,sofa,crossclassified,1,1,0
7691,cheese,soup,crossclassified,1,0,1
7660,apple,glass,crossclassified,1,0,1
7657,statue,swan,crossclassified,1,1,0
7656,goose,statue,crossclassified,1,0,1
7655,statue,wings,crossclassified,1,1,0
7653,baking,table,crossclassified,1,0,1
7652,table,treat,crossclassified,1,1,0
7650,cabinet,furnishing,hypernymy.2,1,1,0
7649,cabinet,center,crossclassified,1,1,0
7647,cake,sign,crossclassified,1,1,0
7645,bathtub,cycle,crossclassified,1,1,0
7643,dog,fluffy,crossclassified,1,1,0
7641,camail,swan,crossclassified,1,0,1
7639,galls,glass,crossclassified,1,0,1
7638,bushes,woman,crossclassified,1,0,1
7636,deck,table,crossclassified,1,0,1
7635,mirror,shirt,crossclassified,1,0,1
7634,setting,skateboarder,crossclassified,1,0,1
8394,cup,laptop,crossclassified,1,1,0
8396,cup,destine,crossclassified,1,1,0
9388,dustbin,sandwich,crossclassified,1,0,1
9058,car,sunglasses,crossclassified,1,1,0
9046,grill,train,crossclassified,1,0,1
9050,mane,toy,crossclassified,1,0,1
9053,eyes,toy,crossclassified,1,0,1
9054,bed,ceiling,crossclassified,1,1,0
9055,cake,sauce,crossclassified,1,1,0
9057,car,eyeglass,crossclassified,1,1,0
9063,bun,cheeseburger,crossclassified,1,1,0
9039,belt,tie,crossclassified,1,0,1
9064,bowl,grape,crossclassified,1,1,0
9068,belt,rug,crossclassified,1,0,1
9069,couch,curtain,crossclassified,1,0,1
9073,leaf,umbrella,crossclassified,1,0,1
9074,sunshade,umbrella,co-hyponymy,1,0,1
9075,ampullae,umbrella,crossclassified,1,0,1
9042,motorcycle,pick,crossclassified,1,1,0
9037,boat,peak,crossclassified,1,1,0
8397,cat,scarf,crossclassified,1,1,0
9023,painting,woman,crossclassified,1,0,1
9013,baguette,hotdog,crossclassified,1,0,1
9014,frank,hotdog,synonymy,1,0,1
9016,ship,vehicle,hypernymy.2,1,1,0
9017,jacket,overskirt,crossclassified,1,1,0
9021,building,steps,crossclassified,1,1,0
9022,art,woman,crossclassified,1,0,1
9025,cart,suit,crossclassified,1,0,1
9036,dog,sheet,crossclassified,1,1,0
9027,scissor,toilet,crossclassified,1,0,1
9028,dustbin,toilet,crossclassified,1,0,1
9029,guy,jacket,crossclassified,1,0,1
9030,desk,sleeveless,crossclassified,1,1,0
9034,boat,lorry,crossclassified,1,1,0
9035,couch,lamb,crossclassified,1,1,0
9078,head,human,crossclassified,1,1,0
9080,head,kid,crossclassified,1,1,0
9081,head,table,crossclassified,1,1,0
9130,shed,wall,crossclassified,1,1,0
9121,flower,jug,crossclassified,1,1,0
9124,jacket,sucker,crossclassified,1,1,0
9125,dag,sheep,crossclassified,1,0,1
9127,aurous,food,crossclassified,1,0,1
9128,food,juices,hypernymy.1,1,1,0
9129,shed,wood,crossclassified,1,1,0
9131,pole,shed,crossclassified,1,0,1
9082,boodle,bowl,crossclassified,1,0,1
9134,bear,game,crossclassified,1,0,1
9135,carnival,game,crossclassified,1,0,1
9136,game,stand,crossclassified,1,1,0
9138,game,shelf,crossclassified,1,1,0
9139,caravan,game,crossclassified,1,0,1
9140,game,truck,crossclassified,1,1,0
9120,pan,vessel,co-hyponymy,1,1,0
9119,bun,pan,crossclassified,1,0,1
9115,transport,truck,hypernymy.1,1,0,1
9113,cyclist,shirt,crossclassified,1,0,1
9112,shirt,wheel,crossclassified,1,1,0
9109,electronics,phone,crossclassified,1,0,1
9107,pad,phone,crossclassified,1,0,1
9105,fruit,yogurt,crossclassified,1,1,0
9104,bicycle,van,crossclassified,1,0,1
9100,bench,frisbee,crossclassified,1,1,0
9096,cupboard,toothbrush,crossclassified,1,0,1
9095,controller,toothbrush,crossclassified,1,0,1
9092,brash,toothbrush,crossclassified,1,0,1
9089,cucumber,vegetables,hypernymy.2,1,0,1
9088,jacket,smock,crossclassified,1,1,0
9086,cream,jacket,crossclassified,1,0,1
9084,soccer,woman,crossclassified,1,0,1
9012,bench,guardrail,crossclassified,1,1,0
9011,bench,sneakers,crossclassified,1,1,0
9010,dog,scatting,crossclassified,1,1,0
8938,bowl,ramp,crossclassified,1,0,1
8929,bathtub,pipe,crossclassified,1,1,0
8930,rider,shoe,crossclassified,1,0,1
8932,boat,step,crossclassified,1,1,0
8933,boat,strap,crossclassified,1,1,0
8936,ramp,skate,crossclassified,1,1,0
8937,cement,ramp,crossclassified,1,0,1
8939,concrete,ramp,crossclassified,1,0,1
8948,dress,statue,crossclassified,1,1,0
8940,ramp,wall,crossclassified,1,1,0
8942,cake,sofa,crossclassified,1,0,1
8943,sofa,surfboard,crossclassified,1,1,0
8944,plate,sofa,crossclassified,1,0,1
8945,airplane,unclear,crossclassified,1,1,0
8946,dress,tutu,crossclassified,1,1,0
8928,tire,woman,crossclassified,1,0,1
8926,game,woman,crossclassified,1,0,1
8925,grass,woman,crossclassified,1,0,1
8924,bargainer,hotdog,crossclassified,1,0,1
8923,bench,guitar,crossclassified,1,1,0
8922,chart,couch,crossclassified,1,0,1
8921,dress,git,crossclassified,1,1,0
8918,chair,jeans,crossclassified,1,1,0
8916,balconies,building,co-hyponymy,1,0,1
8914,building,terrace,crossclassified,1,1,0
8913,building,steel,crossclassified,1,1,0
8912,building,verandas,crossclassified,1,1,0
8911,motorcycle,possessions,crossclassified,1,1,0
8909,flag,house,crossclassified,1,0,1
8907,buffet,cake,crossclassified,1,0,1
8906,dress,taiyuan,crossclassified,1,1,0
8905,dress,matey,crossclassified,1,1,0
8947,dress,plaster,crossclassified,1,1,0
8949,broccoli,bur,crossclassified,1,1,0
9008,fork,furniture,crossclassified,1,1,0
8996,leaf,train,crossclassified,1,0,1
8985,airplane,bus,crossclassified,1,1,0
8988,like,shirt,crossclassified,1,0,1
8989,shirt,zipper,crossclassified,1,1,0
8990,eating,shirt,crossclassified,1,0,1
8992,bird,cockatiel,hypernymy.1,1,1,0
8993,flower,glass,crossclassified,1,1,0
9000,bottle,dropper,crossclassified,1,1,0
8950,broccoli,bucket,crossclassified,1,1,0
9001,bluebottle,bottle,crossclassified,1,0,1
9002,bottle,featherbedding,crossclassified,1,1,0
9004,cover,desk,crossclassified,1,0,1
9005,impersonator,jacket,crossclassified,1,0,1
9006,fork,orange,crossclassified,1,1,0
9007,fork,sauce,crossclassified,1,1,0
8983,airplane,box,crossclassified,1,1,0
8981,home,truck,crossclassified,1,0,1
8980,cupcakes,desert,crossclassified,1,1,0
8975,boat,short,crossclassified,1,1,0
8974,elbow,lamp,crossclassified,1,0,1
8973,lamp,shirt,crossclassified,1,1,0
8972,jug,lamp,crossclassified,1,0,1
8971,apple,ball,crossclassified,1,1,0
8970,dog,oat,crossclassified,1,1,0
8969,brutes,hotdog,crossclassified,1,0,1
8967,bucket,vessel,hypernymy.2,1,1,0
8965,cell,phone,hypernymy.2,1,0,1
8962,counter,meals,crossclassified,1,1,0
8961,manlike,shirt,crossclassified,1,0,1
8960,breaches,shirt,crossclassified,1,0,1
8954,giraffe,legs,crossclassified,1,1,0
8952,broccoli,cup,crossclassified,1,1,0
9141,fair,game,crossclassified,1,0,1
9142,mirror,spoon,crossclassified,1,0,1
9143,silver,spoon,crossclassified,1,0,1
9309,carriages,train,crossclassified,1,0,1
9299,hitch,motorcycle,crossclassified,1,0,1
9300,boy,striker,crossclassified,1,1,0
9303,counter,sandwiches,crossclassified,1,1,0
9304,jacket,sand,crossclassified,1,1,0
9305,chair,day,crossclassified,1,1,0
9307,abort,counter,crossclassified,1,0,1
9311,washingtonian,woman,crossclassified,1,0,1
9323,bikes,bridge,crossclassified,1,0,1
9312,cat,pill,crossclassified,1,1,0
9313,dress,pride,crossclassified,1,1,0
9315,carpet,motor,crossclassified,1,1,0
9316,carpet,platform,crossclassified,1,1,0
9317,carpet,chrome,crossclassified,1,1,0
9320,boy,teammate,crossclassified,1,1,0
9297,floor,grill,crossclassified,1,1,0
9296,floor,slipper,crossclassified,1,1,0
9295,floor,sandal,crossclassified,1,1,0
9293,charger,shirt,crossclassified,1,0,1
9291,bed,ware,crossclassified,1,1,0
9289,table,tininess,crossclassified,1,1,0
9288,bed,blow,crossclassified,1,1,0
9287,jacket,zip,crossclassified,1,1,0
9286,bridge,drawbridge,hypernymy.1,1,1,0
9284,nurse,t-shirt,crossclassified,1,1,0
9283,cardigan,nurse,crossclassified,1,0,1
9282,nurse,stethoscope,crossclassified,1,1,0
9281,doctor,nurse,crossclassified,1,0,1
9279,cap,nurse,crossclassified,1,0,1
9276,sandbagged,sandwich,crossclassified,1,0,1
9275,biped,cow,crossclassified,1,0,1
9272,cement,wall,crossclassified,1,0,1
9321,boy,preteen,crossclassified,1,1,0
9324,bridge,houses,crossclassified,1,1,0
9270,concrete,wall,crossclassified,1,0,1
9369,desk,keypad,crossclassified,1,1,0
9363,bucket,cub,crossclassified,1,1,0
9364,shirts,surfer,crossclassified,1,0,1
9365,cat,eye,crossclassified,1,1,0
9366,carpet,shorts,crossclassified,1,1,0
9367,sandwich,sausage,crossclassified,1,1,0
9368,girl,shocks,crossclassified,1,1,0
9370,chair,father,crossclassified,1,1,0
9326,jacket,motile,crossclassified,1,1,0
9373,cat,grass,crossclassified,1,1,0
9375,dugout,pipe,crossclassified,1,1,0
9383,animal,water,crossclassified,1,0,1
9384,tail,water,crossclassified,1,0,1
9385,man,workman,crossclassified,1,1,0
9387,bracket,sandwich,crossclassified,1,0,1
9362,bucket,nuke,crossclassified,1,1,0
9358,giraffe,lipread,crossclassified,1,1,0
9357,apple,girl,crossclassified,1,0,1
9353,carat,dog,crossclassified,1,0,1
9352,rose,suit,crossclassified,1,0,1
9350,boy,fielder,crossclassified,1,1,0
9349,cow,hippo,crossclassified,1,1,0
9346,flower,light,crossclassified,1,1,0
9340,child,suffocating,crossclassified,1,1,0
9339,jar,mug,co-hyponymy,1,1,0
9338,dog,pill,crossclassified,1,1,0
9337,floor,hair,crossclassified,1,1,0
9335,duck,ornament,crossclassified,1,1,0
9334,decoration,duck,crossclassified,1,0,1
9333,duck,toll,crossclassified,1,1,0
9329,coloured,skier,crossclassified,1,0,1
9328,skier,tag,crossclassified,1,1,0
9271,curb,wall,crossclassified,1,0,1
9268,chair,television,crossclassified,1,1,0
9144,art,spoon,crossclassified,1,0,1
9182,spoon,spun,crossclassified,1,1,0
9166,books,suitcase,crossclassified,1,0,1
9171,lonesome,suitcase,crossclassified,1,0,1
9173,farm,house,crossclassified,1,0,1
9177,chips,food,hypernymy.2,1,0,1
9179,tile,woman,crossclassified,1,0,1
9181,spoon,tribune,crossclassified,1,1,0
9186,blender,juke,crossclassified,1,1,0
9199,harness,man,crossclassified,1,0,1
9188,shirt,toothpastes,crossclassified,1,1,0
9189,shirt,teeth,crossclassified,1,1,0
9193,house,owl,crossclassified,1,1,0
9194,cow,needle,crossclassified,1,1,0
9195,cow,drug,crossclassified,1,1,0
9196,camel,cow,crossclassified,1,0,1
9165,cat,scissor,crossclassified,1,1,0
9164,shirt,stripes,crossclassified,1,1,0
9163,bed,monitor,crossclassified,1,1,0
9162,broth,food,hypernymy.2,1,0,1
9161,bun,pie,crossclassified,1,0,1
9160,egg,pie,crossclassified,1,0,1
9158,airplane,player,crossclassified,1,1,0
9157,backdrop,house,crossclassified,1,0,1
9156,house,signboard,crossclassified,1,1,0
9155,radish,vegetables,hypernymy.2,1,0,1
9154,vegetables,veggies,synonymy,1,1,0
9153,veg,vegetables,synonymy,1,0,1
9152,produce,vegetables,hypernymy.1,1,0,1
9151,fennel,vegetables,hypernymy.2,1,0,1
9150,dill,vegetables,co-hyponymy,1,0,1
9149,vegetables,wooden,crossclassified,1,1,0
9145,ball,spoon,crossclassified,1,0,1
9197,computer,suit,crossclassified,1,0,1
9201,kimono,women,crossclassified,1,1,0
9266,bird,ship,crossclassified,1,1,0
9250,child,tot,hypernymy.1,1,1,0
9244,dough,pie,crossclassified,1,1,0
9245,car,sheriff,crossclassified,1,1,0
9246,frock,jacket,crossclassified,1,0,1
9247,door,jacket,crossclassified,1,0,1
9248,jacket,vestments,crossclassified,1,1,0
9249,giraffe,grief,crossclassified,1,1,0
9251,mozzarella,sandwich,crossclassified,1,0,1
9204,jacket,kimono,crossclassified,1,0,1
9253,player,skateboarder,crossclassified,1,0,1
9257,quiche,soup,crossclassified,1,0,1
9258,ratatouille,soup,crossclassified,1,0,1
9259,giraffe,grass,crossclassified,1,1,0
9263,bench,tattoos,crossclassified,1,1,0
9264,desk,typewriter,crossclassified,1,1,0
9243,crust,dough,crossclassified,1,0,1
9241,wheel,window,crossclassified,1,0,1
9240,meerkat,window,crossclassified,1,0,1
9238,olives,pizza,crossclassified,1,0,1
9236,mere,sheep,crossclassified,1,0,1
9235,conterminous,desk,crossclassified,1,0,1
9232,bottle,toothpaste,crossclassified,1,1,0
9227,building,railing,crossclassified,1,1,0
9226,blender,fruits,crossclassified,1,1,0
9223,car,skater,crossclassified,1,1,0
9218,lodge,outhouse,crossclassified,1,0,1
9215,outhouse,toilet,crossclassified,1,1,0
9210,man,preacher,crossclassified,1,1,0
9209,cover,tent,crossclassified,1,0,1
9207,food,grandma,crossclassified,1,1,0
9206,cakes,sandwich,crossclassified,1,0,1
9205,man,setting,crossclassified,1,1,0
8903,fork,spue,crossclassified,1,1,0
8902,appetizer,bread,crossclassified,1,0,1
8901,bread,shell,crossclassified,1,1,0
8568,toilet,vase,crossclassified,1,1,0
8558,boy,schoolchild,crossclassified,1,1,0
8559,boat,towel,crossclassified,1,1,0
8560,eyeglass,suit,crossclassified,1,0,1
8561,monster,table,crossclassified,1,0,1
8562,peeling,table,crossclassified,1,0,1
8564,oil,table,crossclassified,1,0,1
8571,building,costa,crossclassified,1,1,0
8587,motorcycles,road,crossclassified,1,1,0
8572,butt,goat,synonymy,1,0,1
8573,goat,horse,crossclassified,1,1,0
8575,football,jacket,crossclassified,1,0,1
8579,huts,tent,co-hyponymy,1,0,1
8580,ladle,shirt,crossclassified,1,0,1
8584,motorcycles,street,crossclassified,1,1,0
8556,furniture,pizza,crossclassified,1,0,1
8555,cat,pizza,crossclassified,1,0,1
8553,diary,shirt,crossclassified,1,0,1
8551,building,pipe,crossclassified,1,1,0
8550,juicer,man,crossclassified,1,0,1
8549,man,sleeveless,crossclassified,1,1,0
8548,desk,girl,crossclassified,1,0,1
8547,girl,sizer,crossclassified,1,1,0
8544,drain,sink,crossclassified,1,0,1
8542,sink,wooden,crossclassified,1,1,0
8541,cat,washroom,crossclassified,1,1,0
8540,cat,meat,crossclassified,1,1,0
8539,bicycle,skateboarder,crossclassified,1,0,1
8538,car,passenger,crossclassified,1,1,0
8536,trimmer,woman,crossclassified,1,0,1
8535,plane,stairway,crossclassified,1,1,0
8534,person,plane,crossclassified,1,0,1
8586,floor,motorcycles,crossclassified,1,0,1
8590,cup,pen,crossclassified,1,1,0
8532,bench,frog,crossclassified,1,1,0
8643,curtain,shoe,crossclassified,1,1,0
8634,ache,boat,crossclassified,1,0,1
8635,boy,cartwheel,crossclassified,1,1,0
8636,desk,unknown,crossclassified,1,1,0
8638,glass,vest,crossclassified,1,0,1
8640,table,tag,crossclassified,1,1,0
8641,handbag,house,crossclassified,1,0,1
8646,mirror,plate,crossclassified,1,1,0
8595,jacket,tray,crossclassified,1,1,0
8648,curtain,severance,crossclassified,1,1,0
8651,flamingo,peak,crossclassified,1,1,0
8652,flamingo,statue,crossclassified,1,1,0
8655,man,wrap,crossclassified,1,1,0
8658,blat,shirt,crossclassified,1,0,1
8659,basket,woman,crossclassified,1,0,1
8631,man,sundials,crossclassified,1,1,0
8630,food,house,crossclassified,1,0,1
8626,cow,wooded,crossclassified,1,1,0
8625,basin,cabinet,crossclassified,1,0,1
8621,carpet,slacks,crossclassified,1,1,0
8618,carpet,coat,crossclassified,1,1,0
8616,curtain,house,crossclassified,1,0,1
8614,sandwich,t-shirt,crossclassified,1,1,0
8613,man,rest,crossclassified,1,1,0
8612,nook,swan,crossclassified,1,0,1
8610,bed,numberplate,crossclassified,1,1,0
8609,bed,signal,crossclassified,1,1,0
8607,boat,plant,crossclassified,1,1,0
8603,carpet,leg,crossclassified,1,1,0
8601,dog,eyeglass,crossclassified,1,1,0
8597,bangle,child,crossclassified,1,0,1
8596,presents,table,crossclassified,1,0,1
8533,bowl,kitchen,crossclassified,1,1,0
8530,train,trolleybus,crossclassified,1,1,0
8662,blinders,curtain,co-hyponymy,1,0,1
8437,button,knife,crossclassified,1,0,1
8429,boy,headphone,crossclassified,1,1,0
8430,bowl,chocolate,crossclassified,1,1,0
8431,bowl,pretzels,crossclassified,1,1,0
8432,bowl,crackers,crossclassified,1,1,0
8433,parrot,woman,crossclassified,1,0,1
8435,knife,wooden,crossclassified,1,1,0
8439,knife,tool,hypernymy.2,1,1,0
8454,animal,horn,crossclassified,1,1,0
8441,tab,table,crossclassified,1,0,1
8443,olive,table,crossclassified,1,0,1
8448,cake,candies,crossclassified,1,1,0
8449,cake,candy,crossclassified,1,1,0
8450,men,shirt,crossclassified,1,0,1
8451,books,girl,crossclassified,1,0,1
8427,cutter,shirt,crossclassified,1,0,1
8426,boy,fruit,crossclassified,1,1,0
8424,boys,garage,crossclassified,1,0,1
8423,dress,garage,crossclassified,1,0,1
8422,garage,short,crossclassified,1,1,0
8420,boat,transportation,crossclassified,1,1,0
8419,boat,jeep,crossclassified,1,1,0
8418,boy,short,crossclassified,1,1,0
8416,hotdog,sneeze,crossclassified,1,1,0
8415,airplane,traveler,crossclassified,1,1,0
8413,bucket,daddy,crossclassified,1,1,0
8405,shoe,teenager,crossclassified,1,1,0
8403,baby,infant,synonymy,1,1,0
8402,baby,paper,crossclassified,1,1,0
8401,dress,scarf,crossclassified,1,1,0
8400,children,dress,crossclassified,1,0,1
8398,donut,face,crossclassified,1,1,0
8452,frog,girl,crossclassified,1,0,1
8455,animal,mule,hypernymy.1,1,1,0
8529,airplane,horse,crossclassified,1,1,0
8504,jeans,motorcycle,crossclassified,1,0,1
8494,bed,head,crossclassified,1,1,0
8495,snow,track,crossclassified,1,1,0
8496,snow,wire,crossclassified,1,1,0
8497,chair,snow,crossclassified,1,0,1
8500,lift,snow,crossclassified,1,0,1
8501,ride,snow,crossclassified,1,0,1
8505,motorcycle,pants,crossclassified,1,1,0
8456,curtains,woman,crossclassified,1,0,1
8515,blanket,sofa,crossclassified,1,1,0
8517,rug,tail,crossclassified,1,1,0
8519,handle,tub,crossclassified,1,0,1
8521,donut,tile,crossclassified,1,1,0
8526,brio,dresser,crossclassified,1,0,1
8528,beer,dresser,crossclassified,1,0,1
8491,desk,tomato,crossclassified,1,1,0
8490,desk,peaches,crossclassified,1,1,0
8488,giraffe,roof,crossclassified,1,1,0
8484,hay,horse,crossclassified,1,0,1
8483,cupboard,train,crossclassified,1,0,1
8481,man,washingtonian,crossclassified,1,1,0
8480,man,victim,co-hyponymy,1,1,0
8479,man,torture,crossclassified,1,1,0
8474,cabinet,plug,crossclassified,1,1,0
8473,bureau,cabinet,co-hyponymy,1,0,1
8471,sandwich,sweet,crossclassified,1,1,0
8470,crossopterygian,sandwich,crossclassified,1,0,1
8469,flower,man,crossclassified,1,0,1
8468,vase,water,crossclassified,1,0,1
8467,drink,water,hypernymy.2,1,0,1
8464,jacket,wood,crossclassified,1,1,0
8463,kayaking,sandwich,crossclassified,1,0,1
8660,girl,sneakers,crossclassified,1,1,0
8663,birch,bridge,crossclassified,1,0,1
8900,barrage,bread,crossclassified,1,0,1
8824,pads,surfer,crossclassified,1,0,1
8816,jacket,tab,crossclassified,1,1,0
8817,curtain,pole,crossclassified,1,1,0
8818,curtain,sneer,crossclassified,1,1,0
8819,bur,rice,crossclassified,1,0,1
8821,cucumber,rice,crossclassified,1,0,1
8823,potatoes,rice,co-hyponymy,1,0,1
8826,surfer,surfing,crossclassified,1,1,0
8837,child,remote,crossclassified,1,1,0
8827,counter,washer,crossclassified,1,1,0
8828,carrot,pizza,crossclassified,1,0,1
8830,desk,sweets,crossclassified,1,1,0
8831,candy,desk,crossclassified,1,0,1
8832,bathtub,table,crossclassified,1,1,0
8834,bathtub,scissor,crossclassified,1,1,0
8814,building,elf,crossclassified,1,1,0
8812,pa,pizza,crossclassified,1,0,1
8811,corp,hat,crossclassified,1,0,1
8809,hat,scarf,crossclassified,1,1,0
8808,bread,wooden,crossclassified,1,1,0
8804,bare,bread,crossclassified,1,0,1
8803,costume,gown,crossclassified,1,0,1
8802,court,gown,crossclassified,1,0,1
8800,gown,uniform,crossclassified,1,1,0
8799,gown,suit,co-hyponymy,1,1,0
8796,gown,t-shirt,crossclassified,1,1,0
8795,donkey,zebra,crossclassified,1,0,1
8794,car,centerboard,crossclassified,1,1,0
8793,box,packet,crossclassified,1,1,0
8792,box,wooded,crossclassified,1,1,0
8790,glider,shoot,crossclassified,1,1,0
8789,glider,wings,crossclassified,1,1,0
8835,bathtub,kitty,crossclassified,1,1,0
8839,child,sitting,crossclassified,1,1,0
8787,glider,shirt,crossclassified,1,1,0
8878,blender,sun,crossclassified,1,1,0
8868,house,jackal,crossclassified,1,1,0
8872,car,compact,hypernymy.1,1,1,0
8873,flower,follower,crossclassified,1,1,0
8874,nuts,pan,crossclassified,1,0,1
8875,pan,sauteed,crossclassified,1,1,0
8876,mushroom,pan,crossclassified,1,0,1
8882,blanket,jackal,crossclassified,1,1,0
8841,bridge,plat,crossclassified,1,1,0
8884,blanket,pole,crossclassified,1,1,0
8886,blanket,cloak,crossclassified,1,1,0
8888,blanket,shawl,crossclassified,1,1,0
8893,pool,zebra,crossclassified,1,0,1
8894,motorcycle,white,crossclassified,1,1,0
8895,driver,motorcycle,crossclassified,1,0,1
8867,house,shutter,crossclassified,1,1,0
8865,laptop,sofa,crossclassified,1,1,0
8863,laptop,monitor,crossclassified,1,1,0
8860,dumplings,food,hypernymy.2,1,0,1
8858,sign,tree,crossclassified,1,1,0
8857,sign,signatory,crossclassified,1,1,0
8856,pole,sign,crossclassified,1,0,1
8855,numberplate,sign,crossclassified,1,0,1
8854,dad,person,hypernymy.2,1,0,1
8853,adult,person,hypernymy.2,1,0,1
8852,dress,frog,crossclassified,1,1,0
8850,horse,net,crossclassified,1,1,0
8849,bridge,cow,crossclassified,1,1,0
8847,face,sheep,crossclassified,1,0,1
8845,sauce,vegetables,crossclassified,1,1,0
8843,couch,flooring,crossclassified,1,1,0
8842,couch,rack,crossclassified,1,1,0
8788,glider,shoe,crossclassified,1,1,0
8786,cap,glider,crossclassified,1,0,1
8664,motorcycle,riders,crossclassified,1,1,0
8701,motorcycle,rote,crossclassified,1,1,0
8691,baseball,man,crossclassified,1,0,1
8693,vest,wheel,crossclassified,1,1,0
8694,cycle,vest,crossclassified,1,0,1
8695,pant,vest,co-hyponymy,1,0,1
8696,leatherjacket,vest,crossclassified,1,0,1
8699,comedian,woman,crossclassified,1,0,1
8703,pan,pole,crossclassified,1,1,0
8719,car,ship,crossclassified,1,1,0
8708,food,vagabond,crossclassified,1,1,0
8711,tree,wooden,crossclassified,1,1,0
8713,spoon,tomato,crossclassified,1,1,0
8715,entree,spoon,crossclassified,1,0,1
8716,feel,salad,crossclassified,1,0,1
8717,tap,tub,crossclassified,1,0,1
8689,can,desk,crossclassified,1,0,1
8688,socks,woman,crossclassified,1,0,1
8687,sofa,suit,crossclassified,1,0,1
8684,pizza,sandwiches,crossclassified,1,1,0
8682,boat,skirt,crossclassified,1,1,0
8680,animal,owl,hypernymy.1,1,0,1
8679,awl,owl,crossclassified,1,0,1
8676,hydrant,woman,crossclassified,1,0,1
8675,mack,truck,crossclassified,1,0,1
8674,salsa,sauce,co-hyponymy,1,0,1
8673,meal,sauce,crossclassified,1,0,1
8672,chicken,sauce,crossclassified,1,0,1
8671,barer,sauce,crossclassified,1,0,1
8668,horse,lamb,crossclassified,1,1,0
8667,chicken,woman,crossclassified,1,0,1
8666,skater,sweatshirt,crossclassified,1,1,0
8665,bed,motorcycle,crossclassified,1,0,1
8718,lases,tub,crossclassified,1,0,1
8721,horse,jackal,crossclassified,1,1,0
8785,glider,t-shirt,crossclassified,1,1,0
8764,duck,sink,crossclassified,1,0,1
8758,house,winder,crossclassified,1,1,0
8759,net,sheep,crossclassified,1,0,1
8760,cap,sheep,crossclassified,1,0,1
8761,rail,sheep,crossclassified,1,0,1
8762,jacket,light,crossclassified,1,1,0
8763,carrot,rice,crossclassified,1,0,1
8769,bowl,knife,crossclassified,1,0,1
8722,horse,uniform,crossclassified,1,1,0
8774,controllership,couch,crossclassified,1,0,1
8775,couch,mother,crossclassified,1,1,0
8777,boat,engine,crossclassified,1,1,0
8779,boat,pond,crossclassified,1,1,0
8781,man,salesman,crossclassified,1,1,0
8782,leash,man,crossclassified,1,0,1
8757,bed,home,crossclassified,1,1,0
8756,bad,carpet,crossclassified,1,0,1
8755,carpet,door,crossclassified,1,1,0
8753,ramp,skateboarding,crossclassified,1,1,0
8752,pipe,ramp,crossclassified,1,0,1
8751,deck,ramp,crossclassified,1,0,1
8745,barer,soup,crossclassified,1,0,1
8743,bowel,food,crossclassified,1,0,1
8742,laptop,vase,crossclassified,1,0,1
8741,coat,skateboarder,crossclassified,1,0,1
8740,gloves,skateboarder,crossclassified,1,0,1
8738,giraffe,shoe,crossclassified,1,1,0
8737,house,tv,crossclassified,1,1,0
8735,dog,socks,crossclassified,1,1,0
8734,laboratory,woman,crossclassified,1,0,1
8731,bench,hands,crossclassified,1,1,0
8728,bottle,gals,crossclassified,1,1,0
15824,book,skateboarder,crossclassified,1,0,1
